,Campus,Cumulative,Projected,Date,Difference,Type
0,Anderson Mill,465,545,2012-09-11,-80,ES
1,Berkman,526,551,2012-09-11,-25,ES
2,Blackland Prairie,903,895,2012-09-11,8,ES
3,Bluebonnet,634,713,2012-09-11,-79,ES
4,Brushy Creek,778,782,2012-09-11,-4,ES
5,C.D. Fulkes,791,741,2012-09-11,50,MS
6,Cactus Ranch,984,951,2012-09-11,33,ES
7,Caldwell Heights,598,646,2012-09-11,-48,ES
8,Callison,863,930,2012-09-11,-67,ES
9,Canyon Creek,437,464,2012-09-11,-27,ES
10,Canyon Vista,1273,1259,2012-09-11,14,MS
11,Caraway,659,689,2012-09-11,-30,ES
12,Cedar Ridge,2879,2979,2012-09-11,-100,HS
13,Cedar Valley,1250,1241,2012-09-11,9,MS
14,Chandler Oaks,617,618,2012-09-11,-1,ES
15,Chisholm Trail,1061,1073,2012-09-11,-12,MS
16,Deepwood,409,411,2012-09-11,-2,ES
17,Deerpark,950,990,2012-09-11,-40,MS
18,Double File Trail,681,706,2012-09-11,-25,ES
19,DAEP,2,6,2012-09-11,-4,Other
20,England,513,516,2012-09-11,-3,ES
21,Fern Bluff,761,782,2012-09-11,-21,ES
22,Forest Creek,824,827,2012-09-11,-3,ES
23,Forest North,380,399,2012-09-11,-19,ES
24,Gattis,785,779,2012-09-11,6,ES
25,Great Oaks,753,819,2012-09-11,-66,ES
26,Grisham,685,671,2012-09-11,14,MS
27,Hernandez,865,936,2012-09-11,-71,MS
28,Herrington,702,644,2012-09-11,58,ES
29,Hopewell,870,854,2012-09-11,16,MS
30,LOTT,21,22,2012-09-11,-1,Other
31,Jollyville,504,550,2012-09-11,-46,ES
32,Laurel Mountain,768,727,2012-09-11,41,ES
33,Live Oak,562,562,2012-09-11,0,ES
34,McNeil,2435,2450,2012-09-11,-15,HS
35,Old Town,819,834,2012-09-11,-15,ES
36,Pond Springs,651,663,2012-09-11,-12,ES
37,Purple Sage,347,318,2012-09-11,29,ES
38,Round Rock Opportunity Center,57,80,2012-09-11,-23,Other
39,Ridgeview,1354,1395,2012-09-11,-41,MS
40,Robertson,523,563,2012-09-11,-40,ES
41,Round Rock,2733,2812,2012-09-11,-79,HS
42,Sommer,813,716,2012-09-11,97,ES
43,Spicewood,720,703,2012-09-11,17,ES
44,Stony Point,2294,2380,2012-09-11,-86,HS
45,Success,104,200,2012-09-11,-96,HS
46,Teravista,757,828,2012-09-11,-71,ES
47,Union Hill,833,856,2012-09-11,-23,ES
48,Voigt,616,727,2012-09-11,-111,ES
49,Walsh,1270,1227,2012-09-11,43,MS
50,Wells Branch,910,924,2012-09-11,-14,ES
51,Westwood,2589,2593,2012-09-11,-4,HS
52,Anderson Mill,461,545,2012-10-02,-84,ES
53,Berkman,525,551,2012-10-02,-26,ES
54,Blackland Prairie,911,895,2012-10-02,16,ES
55,Bluebonnet,644,713,2012-10-02,-69,ES
56,Brushy Creek,785,782,2012-10-02,3,ES
57,C.D. Fulkes,793,741,2012-10-02,52,MS
58,Cactus Ranch,988,951,2012-10-02,37,ES
59,Caldwell Heights,601,646,2012-10-02,-45,ES
60,Callison,860,930,2012-10-02,-70,ES
61,Canyon Creek,438,464,2012-10-02,-26,ES
62,Canyon Vista,1273,1259,2012-10-02,14,MS
63,Caraway,661,689,2012-10-02,-28,ES
64,Cedar Ridge,2864,2979,2012-10-02,-115,HS
65,Cedar Valley,1250,1241,2012-10-02,9,MS
66,Chandler Oaks,616,618,2012-10-02,-2,ES
67,Chisholm Trail,1059,1073,2012-10-02,-14,MS
68,Deepwood,411,411,2012-10-02,0,ES
69,Deerpark,949,990,2012-10-02,-41,MS
70,Double File Trail,680,706,2012-10-02,-26,ES
71,DAEP,4,6,2012-10-02,-2,Other
72,England,512,516,2012-10-02,-4,ES
73,Fern Bluff,759,782,2012-10-02,-23,ES
74,Forest Creek,819,827,2012-10-02,-8,ES
75,Forest North,380,399,2012-10-02,-19,ES
76,Gattis,786,779,2012-10-02,7,ES
77,Great Oaks,751,819,2012-10-02,-68,ES
78,Grisham,687,671,2012-10-02,16,MS
79,Hernandez,864,936,2012-10-02,-72,MS
80,Herrington,702,644,2012-10-02,58,ES
81,Hopewell,874,854,2012-10-02,20,MS
82,LOTT,25,22,2012-10-02,3,Other
83,Jollyville,510,550,2012-10-02,-40,ES
84,Laurel Mountain,767,727,2012-10-02,40,ES
85,Live Oak,567,562,2012-10-02,5,ES
86,McNeil,2427,2450,2012-10-02,-23,HS
87,Old Town,817,834,2012-10-02,-17,ES
88,Pond Springs,650,663,2012-10-02,-13,ES
89,Purple Sage,348,318,2012-10-02,30,ES
90,Round Rock Opportunity Center,78,80,2012-10-02,-2,Other
91,Ridgeview,1352,1395,2012-10-02,-43,MS
92,Robertson,528,563,2012-10-02,-35,ES
93,Round Rock,2719,2812,2012-10-02,-93,HS
94,Sommer,815,716,2012-10-02,99,ES
95,Spicewood,722,703,2012-10-02,19,ES
96,Stony Point,2289,2380,2012-10-02,-91,HS
97,Success,121,200,2012-10-02,-79,HS
98,Teravista,759,828,2012-10-02,-69,ES
99,Union Hill,833,856,2012-10-02,-23,ES
100,Voigt,607,727,2012-10-02,-120,ES
101,Walsh,1270,1227,2012-10-02,43,MS
102,Wells Branch,900,924,2012-10-02,-24,ES
103,Westwood,2591,2593,2012-10-02,-2,HS
104,Anderson Mill,461,545,2012-10-16,-84,ES
105,Berkman,530,551,2012-10-16,-21,ES
106,Blackland Prairie,912,895,2012-10-16,17,ES
107,Bluebonnet,640,713,2012-10-16,-73,ES
108,Brushy Creek,784,782,2012-10-16,2,ES
109,C.D. Fulkes,783,741,2012-10-16,42,MS
110,Cactus Ranch,990,951,2012-10-16,39,ES
111,Caldwell Heights,603,646,2012-10-16,-43,ES
112,Callison,863,930,2012-10-16,-67,ES
113,Canyon Creek,437,464,2012-10-16,-27,ES
114,Canyon Vista,1274,1259,2012-10-16,15,MS
115,Caraway,661,689,2012-10-16,-28,ES
116,Cedar Ridge,2848,2979,2012-10-16,-131,HS
117,Cedar Valley,1238,1241,2012-10-16,-3,MS
118,Chandler Oaks,623,618,2012-10-16,5,ES
119,Chisholm Trail,1059,1073,2012-10-16,-14,MS
120,Deepwood,412,411,2012-10-16,1,ES
121,Deerpark,953,990,2012-10-16,-37,MS
122,Double File Trail,682,706,2012-10-16,-24,ES
123,DAEP,7,6,2012-10-16,1,Other
124,England,506,516,2012-10-16,-10,ES
125,Fern Bluff,756,782,2012-10-16,-26,ES
126,Forest Creek,820,827,2012-10-16,-7,ES
127,Forest North,383,399,2012-10-16,-16,ES
128,Gattis,786,779,2012-10-16,7,ES
129,Great Oaks,748,819,2012-10-16,-71,ES
130,Grisham,690,671,2012-10-16,19,MS
131,Hernandez,862,936,2012-10-16,-74,MS
132,Herrington,709,644,2012-10-16,65,ES
133,Hopewell,879,854,2012-10-16,25,MS
134,LOTT,24,22,2012-10-16,2,Other
135,Jollyville,509,550,2012-10-16,-41,ES
136,Laurel Mountain,766,727,2012-10-16,39,ES
137,Live Oak,570,562,2012-10-16,8,ES
138,McNeil,2424,2450,2012-10-16,-26,HS
139,Old Town,818,834,2012-10-16,-16,ES
140,Pond Springs,649,663,2012-10-16,-14,ES
141,Purple Sage,349,318,2012-10-16,31,ES
142,Round Rock Opportunity Center,100,80,2012-10-16,20,Other
143,Ridgeview,1345,1395,2012-10-16,-50,MS
144,Robertson,531,563,2012-10-16,-32,ES
145,Round Rock,2708,2812,2012-10-16,-104,HS
146,Sommer,811,716,2012-10-16,95,ES
147,Spicewood,722,703,2012-10-16,19,ES
148,Stony Point,2293,2380,2012-10-16,-87,HS
149,Success,137,200,2012-10-16,-63,HS
150,Teravista,764,828,2012-10-16,-64,ES
151,Union Hill,837,856,2012-10-16,-19,ES
152,Voigt,600,727,2012-10-16,-127,ES
153,Walsh,1270,1227,2012-10-16,43,MS
154,Wells Branch,895,924,2012-10-16,-29,ES
155,Westwood,2586,2593,2012-10-16,-7,HS
156,Anderson Mill,463,545,2012-10-23,-82,ES
157,Berkman,526,551,2012-10-23,-25,ES
158,Blackland Prairie,913,895,2012-10-23,18,ES
159,Bluebonnet,640,713,2012-10-23,-73,ES
160,Brushy Creek,785,782,2012-10-23,3,ES
161,C.D. Fulkes,784,741,2012-10-23,43,MS
162,Cactus Ranch,991,951,2012-10-23,40,ES
163,Caldwell Heights,602,646,2012-10-23,-44,ES
164,Callison,864,930,2012-10-23,-66,ES
165,Canyon Creek,437,464,2012-10-23,-27,ES
166,Canyon Vista,1273,1259,2012-10-23,14,MS
167,Caraway,661,689,2012-10-23,-28,ES
168,Cedar Ridge,2852,2979,2012-10-23,-127,HS
169,Cedar Valley,1237,1241,2012-10-23,-4,MS
170,Chandler Oaks,623,618,2012-10-23,5,ES
171,Chisholm Trail,1057,1073,2012-10-23,-16,MS
172,Deepwood,414,411,2012-10-23,3,ES
173,Deerpark,951,990,2012-10-23,-39,MS
174,Double File Trail,685,706,2012-10-23,-21,ES
175,DAEP,7,6,2012-10-23,1,Other
176,England,511,516,2012-10-23,-5,ES
177,Fern Bluff,757,782,2012-10-23,-25,ES
178,Forest Creek,823,827,2012-10-23,-4,ES
179,Forest North,382,399,2012-10-23,-17,ES
180,Gattis,790,779,2012-10-23,11,ES
181,Great Oaks,746,819,2012-10-23,-73,ES
182,Grisham,690,671,2012-10-23,19,MS
183,Hernandez,863,936,2012-10-23,-73,MS
184,Herrington,710,644,2012-10-23,66,ES
185,Hopewell,879,854,2012-10-23,25,MS
186,LOTT,27,22,2012-10-23,5,Other
187,Jollyville,508,550,2012-10-23,-42,ES
188,Laurel Mountain,766,727,2012-10-23,39,ES
189,Live Oak,570,562,2012-10-23,8,ES
190,McNeil,2422,2450,2012-10-23,-28,HS
191,Old Town,817,834,2012-10-23,-17,ES
192,Pond Springs,650,663,2012-10-23,-13,ES
193,Purple Sage,349,318,2012-10-23,31,ES
194,Round Rock Opportunity Center,102,80,2012-10-23,22,Other
195,Ridgeview,1347,1395,2012-10-23,-48,MS
196,Robertson,530,563,2012-10-23,-33,ES
197,Round Rock,2702,2812,2012-10-23,-110,HS
198,Sommer,811,716,2012-10-23,95,ES
199,Spicewood,725,703,2012-10-23,22,ES
200,Stony Point,2293,2380,2012-10-23,-87,HS
201,Success,132,200,2012-10-23,-68,HS
202,Teravista,758,828,2012-10-23,-70,ES
203,Union Hill,836,856,2012-10-23,-20,ES
204,Voigt,601,727,2012-10-23,-126,ES
205,Walsh,1269,1227,2012-10-23,42,MS
206,Wells Branch,901,924,2012-10-23,-23,ES
207,Westwood,2583,2593,2012-10-23,-10,HS
208,Anderson Mill,464,545,2012-10-30,-81,ES
209,Berkman,529,551,2012-10-30,-22,ES
210,Blackland Prairie,915,895,2012-10-30,20,ES
211,Bluebonnet,643,713,2012-10-30,-70,ES
212,Brushy Creek,786,782,2012-10-30,4,ES
213,C.D. Fulkes,784,741,2012-10-30,43,MS
214,Cactus Ranch,989,951,2012-10-30,38,ES
215,Caldwell Heights,603,646,2012-10-30,-43,ES
216,Callison,864,930,2012-10-30,-66,ES
217,Canyon Creek,437,464,2012-10-30,-27,ES
218,Canyon Vista,1271,1259,2012-10-30,12,MS
219,Caraway,659,689,2012-10-30,-30,ES
220,Cedar Ridge,2848,2979,2012-10-30,-131,HS
221,Cedar Valley,1236,1241,2012-10-30,-5,MS
222,Chandler Oaks,624,618,2012-10-30,6,ES
223,Chisholm Trail,1058,1073,2012-10-30,-15,MS
224,Deepwood,417,411,2012-10-30,6,ES
225,Deerpark,948,990,2012-10-30,-42,MS
226,Double File Trail,684,706,2012-10-30,-22,ES
227,DAEP,9,6,2012-10-30,3,Other
228,England,511,516,2012-10-30,-5,ES
229,Fern Bluff,758,782,2012-10-30,-24,ES
230,Forest Creek,826,827,2012-10-30,-1,ES
231,Forest North,381,399,2012-10-30,-18,ES
232,Gattis,788,779,2012-10-30,9,ES
233,Great Oaks,748,819,2012-10-30,-71,ES
234,Grisham,691,671,2012-10-30,20,MS
235,Hernandez,864,936,2012-10-30,-72,MS
236,Herrington,711,644,2012-10-30,67,ES
237,Hopewell,878,854,2012-10-30,24,MS
238,LOTT,26,22,2012-10-30,4,Other
239,Jollyville,506,550,2012-10-30,-44,ES
240,Laurel Mountain,765,727,2012-10-30,38,ES
241,Live Oak,565,562,2012-10-30,3,ES
242,McNeil,2409,2450,2012-10-30,-41,HS
243,Old Town,821,834,2012-10-30,-13,ES
244,Pond Springs,647,663,2012-10-30,-16,ES
245,Purple Sage,352,318,2012-10-30,34,ES
246,Round Rock Opportunity Center,103,80,2012-10-30,23,Other
247,Ridgeview,1348,1395,2012-10-30,-47,MS
248,Robertson,529,563,2012-10-30,-34,ES
249,Round Rock,2694,2812,2012-10-30,-118,HS
250,Sommer,812,716,2012-10-30,96,ES
251,Spicewood,726,703,2012-10-30,23,ES
252,Stony Point,2288,2380,2012-10-30,-92,HS
253,Success,149,200,2012-10-30,-51,HS
254,Teravista,755,828,2012-10-30,-73,ES
255,Union Hill,833,856,2012-10-30,-23,ES
256,Voigt,601,727,2012-10-30,-126,ES
257,Walsh,1268,1227,2012-10-30,41,MS
258,Wells Branch,905,924,2012-10-30,-19,ES
259,Westwood,2583,2593,2012-10-30,-10,HS
260,Anderson Mill,458,545,2012-11-06,-87,ES
261,Berkman,527,551,2012-11-06,-24,ES
262,Blackland Prairie,917,895,2012-11-06,22,ES
263,Bluebonnet,645,713,2012-11-06,-68,ES
264,Brushy Creek,789,782,2012-11-06,7,ES
265,C.D. Fulkes,784,741,2012-11-06,43,MS
266,Cactus Ranch,992,951,2012-11-06,41,ES
267,Caldwell Heights,601,646,2012-11-06,-45,ES
268,Callison,865,930,2012-11-06,-65,ES
269,Canyon Creek,437,464,2012-11-06,-27,ES
270,Canyon Vista,1274,1259,2012-11-06,15,MS
271,Caraway,663,689,2012-11-06,-26,ES
272,Cedar Ridge,2840,2979,2012-11-06,-139,HS
273,Cedar Valley,1234,1241,2012-11-06,-7,MS
274,Chandler Oaks,624,618,2012-11-06,6,ES
275,Chisholm Trail,1053,1073,2012-11-06,-20,MS
276,Deepwood,415,411,2012-11-06,4,ES
277,Deerpark,948,990,2012-11-06,-42,MS
278,Double File Trail,683,706,2012-11-06,-23,ES
279,DAEP,8,6,2012-11-06,2,Other
280,England,511,516,2012-11-06,-5,ES
281,Fern Bluff,757,782,2012-11-06,-25,ES
282,Forest Creek,827,827,2012-11-06,0,ES
283,Forest North,378,399,2012-11-06,-21,ES
284,Gattis,792,779,2012-11-06,13,ES
285,Great Oaks,745,819,2012-11-06,-74,ES
286,Grisham,688,671,2012-11-06,17,MS
287,Hernandez,862,936,2012-11-06,-74,MS
288,Herrington,707,644,2012-11-06,63,ES
289,Hopewell,878,854,2012-11-06,24,MS
290,LOTT,28,22,2012-11-06,6,Other
291,Jollyville,509,550,2012-11-06,-41,ES
292,Laurel Mountain,765,727,2012-11-06,38,ES
293,Live Oak,563,562,2012-11-06,1,ES
294,McNeil,2401,2450,2012-11-06,-49,HS
295,Old Town,823,834,2012-11-06,-11,ES
296,Pond Springs,648,663,2012-11-06,-15,ES
297,Purple Sage,352,318,2012-11-06,34,ES
298,Round Rock Opportunity Center,109,80,2012-11-06,29,Other
299,Ridgeview,1348,1395,2012-11-06,-47,MS
300,Robertson,528,563,2012-11-06,-35,ES
301,Round Rock,2691,2812,2012-11-06,-121,HS
302,Sommer,811,716,2012-11-06,95,ES
303,Spicewood,725,703,2012-11-06,22,ES
304,Stony Point,2284,2380,2012-11-06,-96,HS
305,Success,144,200,2012-11-06,-56,HS
306,Teravista,759,828,2012-11-06,-69,ES
307,Union Hill,834,856,2012-11-06,-22,ES
308,Voigt,599,727,2012-11-06,-128,ES
309,Walsh,1269,1227,2012-11-06,42,MS
310,Wells Branch,904,924,2012-11-06,-20,ES
311,Westwood,2585,2593,2012-11-06,-8,HS
312,Anderson Mill,456,545,2012-11-13,-89,ES
313,Berkman,525,551,2012-11-13,-26,ES
314,Blackland Prairie,917,895,2012-11-13,22,ES
315,Bluebonnet,642,713,2012-11-13,-71,ES
316,Brushy Creek,794,782,2012-11-13,12,ES
317,C.D. Fulkes,785,741,2012-11-13,44,MS
318,Cactus Ranch,994,951,2012-11-13,43,ES
319,Caldwell Heights,596,646,2012-11-13,-50,ES
320,Callison,869,930,2012-11-13,-61,ES
321,Canyon Creek,437,464,2012-11-13,-27,ES
322,Canyon Vista,1274,1259,2012-11-13,15,MS
323,Caraway,664,689,2012-11-13,-25,ES
324,Cedar Ridge,2830,2979,2012-11-13,-149,HS
325,Cedar Valley,1233,1241,2012-11-13,-8,MS
326,Chandler Oaks,622,618,2012-11-13,4,ES
327,Chisholm Trail,1053,1073,2012-11-13,-20,MS
328,Deepwood,411,411,2012-11-13,0,ES
329,Deerpark,944,990,2012-11-13,-46,MS
330,Double File Trail,681,706,2012-11-13,-25,ES
331,DAEP,8,6,2012-11-13,2,Other
332,England,508,516,2012-11-13,-8,ES
333,Fern Bluff,756,782,2012-11-13,-26,ES
334,Forest Creek,829,827,2012-11-13,2,ES
335,Forest North,379,399,2012-11-13,-20,ES
336,Gattis,794,779,2012-11-13,15,ES
337,Great Oaks,745,819,2012-11-13,-74,ES
338,Grisham,683,671,2012-11-13,12,MS
339,Hernandez,861,936,2012-11-13,-75,MS
340,Herrington,710,644,2012-11-13,66,ES
341,Hopewell,880,854,2012-11-13,26,MS
342,LOTT,26,22,2012-11-13,4,Other
343,Jollyville,505,550,2012-11-13,-45,ES
344,Laurel Mountain,764,727,2012-11-13,37,ES
345,Live Oak,563,562,2012-11-13,1,ES
346,McNeil,2397,2450,2012-11-13,-53,HS
347,Old Town,826,834,2012-11-13,-8,ES
348,Pond Springs,650,663,2012-11-13,-13,ES
349,Purple Sage,352,318,2012-11-13,34,ES
350,Round Rock Opportunity Center,117,80,2012-11-13,37,Other
351,Ridgeview,1350,1395,2012-11-13,-45,MS
352,Robertson,527,563,2012-11-13,-36,ES
353,Round Rock,2688,2812,2012-11-13,-124,HS
354,Sommer,814,716,2012-11-13,98,ES
355,Spicewood,726,703,2012-11-13,23,ES
356,Stony Point,2277,2380,2012-11-13,-103,HS
357,Success,137,200,2012-11-13,-63,HS
358,Teravista,760,828,2012-11-13,-68,ES
359,Union Hill,835,856,2012-11-13,-21,ES
360,Voigt,597,727,2012-11-13,-130,ES
361,Walsh,1268,1227,2012-11-13,41,MS
362,Wells Branch,905,924,2012-11-13,-19,ES
363,Westwood,2582,2593,2012-11-13,-11,HS
364,Anderson Mill,456,545,2012-11-27,-89,ES
365,Berkman,525,551,2012-11-27,-26,ES
366,Blackland Prairie,916,895,2012-11-27,21,ES
367,Bluebonnet,645,713,2012-11-27,-68,ES
368,Brushy Creek,791,782,2012-11-27,9,ES
369,C.D. Fulkes,784,741,2012-11-27,43,MS
370,Cactus Ranch,997,951,2012-11-27,46,ES
371,Caldwell Heights,598,646,2012-11-27,-48,ES
372,Callison,873,930,2012-11-27,-57,ES
373,Canyon Creek,435,464,2012-11-27,-29,ES
374,Canyon Vista,1276,1259,2012-11-27,17,MS
375,Caraway,666,689,2012-11-27,-23,ES
376,Cedar Ridge,2834,2979,2012-11-27,-145,HS
377,Cedar Valley,1234,1241,2012-11-27,-7,MS
378,Chandler Oaks,621,618,2012-11-27,3,ES
379,Chisholm Trail,1050,1073,2012-11-27,-23,MS
380,Deepwood,414,411,2012-11-27,3,ES
381,Deerpark,941,990,2012-11-27,-49,MS
382,Double File Trail,684,706,2012-11-27,-22,ES
383,DAEP,7,6,2012-11-27,1,Other
384,England,506,516,2012-11-27,-10,ES
385,Fern Bluff,761,782,2012-11-27,-21,ES
386,Forest Creek,831,827,2012-11-27,4,ES
387,Forest North,382,399,2012-11-27,-17,ES
388,Gattis,797,779,2012-11-27,18,ES
389,Great Oaks,748,819,2012-11-27,-71,ES
390,Grisham,681,671,2012-11-27,10,MS
391,Hernandez,860,936,2012-11-27,-76,MS
392,Herrington,703,644,2012-11-27,59,ES
393,Hopewell,878,854,2012-11-27,24,MS
394,LOTT,28,22,2012-11-27,6,Other
395,Jollyville,501,550,2012-11-27,-49,ES
396,Laurel Mountain,763,727,2012-11-27,36,ES
397,Live Oak,563,562,2012-11-27,1,ES
398,McNeil,2394,2450,2012-11-27,-56,HS
399,Old Town,826,834,2012-11-27,-8,ES
400,Pond Springs,653,663,2012-11-27,-10,ES
401,Purple Sage,348,318,2012-11-27,30,ES
402,Round Rock Opportunity Center,111,80,2012-11-27,31,Other
403,Ridgeview,1351,1395,2012-11-27,-44,MS
404,Robertson,526,563,2012-11-27,-37,ES
405,Round Rock,2693,2812,2012-11-27,-119,HS
406,Sommer,812,716,2012-11-27,96,ES
407,Spicewood,725,703,2012-11-27,22,ES
408,Stony Point,2265,2380,2012-11-27,-115,HS
409,Success,143,200,2012-11-27,-57,HS
410,Teravista,765,828,2012-11-27,-63,ES
411,Union Hill,843,856,2012-11-27,-13,ES
412,Voigt,615,727,2012-11-27,-112,ES
413,Walsh,1266,1227,2012-11-27,39,MS
414,Wells Branch,906,924,2012-11-27,-18,ES
415,Westwood,2579,2593,2012-11-27,-14,HS
416,Anderson Mill,456,545,2012-12-04,-89,ES
417,Berkman,525,551,2012-12-04,-26,ES
418,Blackland Prairie,915,895,2012-12-04,20,ES
419,Bluebonnet,638,713,2012-12-04,-75,ES
420,Brushy Creek,792,782,2012-12-04,10,ES
421,C.D. Fulkes,785,741,2012-12-04,44,MS
422,Cactus Ranch,992,951,2012-12-04,41,ES
423,Caldwell Heights,597,646,2012-12-04,-49,ES
424,Callison,875,930,2012-12-04,-55,ES
425,Canyon Creek,437,464,2012-12-04,-27,ES
426,Canyon Vista,1277,1259,2012-12-04,18,MS
427,Caraway,666,689,2012-12-04,-23,ES
428,Cedar Ridge,2833,2979,2012-12-04,-146,HS
429,Cedar Valley,1238,1241,2012-12-04,-3,MS
430,Chandler Oaks,620,618,2012-12-04,2,ES
431,Chisholm Trail,1048,1073,2012-12-04,-25,MS
432,Deepwood,413,411,2012-12-04,2,ES
433,Deerpark,942,990,2012-12-04,-48,MS
434,Double File Trail,683,706,2012-12-04,-23,ES
435,DAEP,11,6,2012-12-04,5,Other
436,England,506,516,2012-12-04,-10,ES
437,Fern Bluff,761,782,2012-12-04,-21,ES
438,Forest Creek,831,827,2012-12-04,4,ES
439,Forest North,384,399,2012-12-04,-15,ES
440,Gattis,799,779,2012-12-04,20,ES
441,Great Oaks,746,819,2012-12-04,-73,ES
442,Grisham,682,671,2012-12-04,11,MS
443,Hernandez,863,936,2012-12-04,-73,MS
444,Herrington,705,644,2012-12-04,61,ES
445,Hopewell,879,854,2012-12-04,25,MS
446,LOTT,25,22,2012-12-04,3,Other
447,Jollyville,494,550,2012-12-04,-56,ES
448,Laurel Mountain,766,727,2012-12-04,39,ES
449,Live Oak,559,562,2012-12-04,-3,ES
450,McNeil,2393,2450,2012-12-04,-57,HS
451,Old Town,829,834,2012-12-04,-5,ES
452,Pond Springs,651,663,2012-12-04,-12,ES
453,Purple Sage,350,318,2012-12-04,32,ES
454,Round Rock Opportunity Center,101,80,2012-12-04,21,Other
455,Ridgeview,1348,1395,2012-12-04,-47,MS
456,Robertson,527,563,2012-12-04,-36,ES
457,Round Rock,2698,2812,2012-12-04,-114,HS
458,Sommer,812,716,2012-12-04,96,ES
459,Spicewood,726,703,2012-12-04,23,ES
460,Stony Point,2261,2380,2012-12-04,-119,HS
461,Success,150,200,2012-12-04,-50,HS
462,Teravista,765,828,2012-12-04,-63,ES
463,Union Hill,843,856,2012-12-04,-13,ES
464,Voigt,614,727,2012-12-04,-113,ES
465,Walsh,1268,1227,2012-12-04,41,MS
466,Wells Branch,907,924,2012-12-04,-17,ES
467,Westwood,2579,2593,2012-12-04,-14,HS
468,Anderson Mill,458,545,2012-12-11,-87,ES
469,Berkman,526,551,2012-12-11,-25,ES
470,Blackland Prairie,915,895,2012-12-11,20,ES
471,Bluebonnet,639,713,2012-12-11,-74,ES
472,Brushy Creek,791,782,2012-12-11,9,ES
473,C.D. Fulkes,784,741,2012-12-11,43,MS
474,Cactus Ranch,991,951,2012-12-11,40,ES
475,Caldwell Heights,602,646,2012-12-11,-44,ES
476,Callison,876,930,2012-12-11,-54,ES
477,Canyon Creek,437,464,2012-12-11,-27,ES
478,Canyon Vista,1276,1259,2012-12-11,17,MS
479,Caraway,666,689,2012-12-11,-23,ES
480,Cedar Ridge,2832,2979,2012-12-11,-147,HS
481,Cedar Valley,1238,1241,2012-12-11,-3,MS
482,Chandler Oaks,620,618,2012-12-11,2,ES
483,Chisholm Trail,1045,1073,2012-12-11,-28,MS
484,Deepwood,416,411,2012-12-11,5,ES
485,Deerpark,940,990,2012-12-11,-50,MS
486,Double File Trail,683,706,2012-12-11,-23,ES
487,DAEP,12,6,2012-12-11,6,Other
488,England,511,516,2012-12-11,-5,ES
489,Fern Bluff,762,782,2012-12-11,-20,ES
490,Forest Creek,832,827,2012-12-11,5,ES
491,Forest North,385,399,2012-12-11,-14,ES
492,Gattis,799,779,2012-12-11,20,ES
493,Great Oaks,747,819,2012-12-11,-72,ES
494,Grisham,682,671,2012-12-11,11,MS
495,Hernandez,862,936,2012-12-11,-74,MS
496,Herrington,703,644,2012-12-11,59,ES
497,Hopewell,880,854,2012-12-11,26,MS
498,LOTT,27,22,2012-12-11,5,Other
499,Jollyville,493,550,2012-12-11,-57,ES
500,Laurel Mountain,767,727,2012-12-11,40,ES
501,Live Oak,558,562,2012-12-11,-4,ES
502,McNeil,2387,2450,2012-12-11,-63,HS
503,Old Town,827,834,2012-12-11,-7,ES
504,Pond Springs,653,663,2012-12-11,-10,ES
505,Purple Sage,352,318,2012-12-11,34,ES
506,Round Rock Opportunity Center,105,80,2012-12-11,25,Other
507,Ridgeview,1348,1395,2012-12-11,-47,MS
508,Robertson,530,563,2012-12-11,-33,ES
509,Round Rock,2695,2812,2012-12-11,-117,HS
510,Sommer,813,716,2012-12-11,97,ES
511,Spicewood,726,703,2012-12-11,23,ES
512,Stony Point,2263,2380,2012-12-11,-117,HS
513,Success,138,200,2012-12-11,-62,HS
514,Teravista,766,828,2012-12-11,-62,ES
515,Union Hill,845,856,2012-12-11,-11,ES
516,Voigt,622,727,2012-12-11,-105,ES
517,Walsh,1268,1227,2012-12-11,41,MS
518,Wells Branch,905,924,2012-12-11,-19,ES
519,Westwood,2579,2593,2012-12-11,-14,HS
520,Anderson Mill,460,545,2012-12-18,-85,ES
521,Berkman,524,551,2012-12-18,-27,ES
522,Blackland Prairie,915,895,2012-12-18,20,ES
523,Bluebonnet,639,713,2012-12-18,-74,ES
524,Brushy Creek,793,782,2012-12-18,11,ES
525,C.D. Fulkes,786,741,2012-12-18,45,MS
526,Cactus Ranch,991,951,2012-12-18,40,ES
527,Caldwell Heights,606,646,2012-12-18,-40,ES
528,Callison,872,930,2012-12-18,-58,ES
529,Canyon Creek,437,464,2012-12-18,-27,ES
530,Canyon Vista,1275,1259,2012-12-18,16,MS
531,Caraway,664,689,2012-12-18,-25,ES
532,Cedar Ridge,2831,2979,2012-12-18,-148,HS
533,Cedar Valley,1235,1241,2012-12-18,-6,MS
534,Chandler Oaks,620,618,2012-12-18,2,ES
535,Chisholm Trail,1045,1073,2012-12-18,-28,MS
536,Deepwood,416,411,2012-12-18,5,ES
537,Deerpark,938,990,2012-12-18,-52,MS
538,Double File Trail,683,706,2012-12-18,-23,ES
539,DAEP,11,6,2012-12-18,5,Other
540,England,513,516,2012-12-18,-3,ES
541,Fern Bluff,762,782,2012-12-18,-20,ES
542,Forest Creek,832,827,2012-12-18,5,ES
543,Forest North,384,399,2012-12-18,-15,ES
544,Gattis,800,779,2012-12-18,21,ES
545,Great Oaks,747,819,2012-12-18,-72,ES
546,Grisham,681,671,2012-12-18,10,MS
547,Hernandez,862,936,2012-12-18,-74,MS
548,Herrington,704,644,2012-12-18,60,ES
549,Hopewell,879,854,2012-12-18,25,MS
550,LOTT,33,22,2012-12-18,11,Other
551,Jollyville,495,550,2012-12-18,-55,ES
552,Laurel Mountain,768,727,2012-12-18,41,ES
553,Live Oak,555,562,2012-12-18,-7,ES
554,McNeil,2386,2450,2012-12-18,-64,HS
555,Old Town,828,834,2012-12-18,-6,ES
556,Pond Springs,654,663,2012-12-18,-9,ES
557,Purple Sage,352,318,2012-12-18,34,ES
558,Round Rock Opportunity Center,111,80,2012-12-18,31,Other
559,Ridgeview,1348,1395,2012-12-18,-47,MS
560,Robertson,538,563,2012-12-18,-25,ES
561,Round Rock,2690,2812,2012-12-18,-122,HS
562,Sommer,812,716,2012-12-18,96,ES
563,Spicewood,727,703,2012-12-18,24,ES
564,Stony Point,2256,2380,2012-12-18,-124,HS
565,Success,132,200,2012-12-18,-68,HS
566,Teravista,765,828,2012-12-18,-63,ES
567,Union Hill,849,856,2012-12-18,-7,ES
568,Voigt,631,727,2012-12-18,-96,ES
569,Walsh,1268,1227,2012-12-18,41,MS
570,Wells Branch,905,924,2012-12-18,-19,ES
571,Westwood,2577,2593,2012-12-18,-16,HS
572,Anderson Mill,462,545,2013-01-08,-83,ES
573,Berkman,519,551,2013-01-08,-32,ES
574,Blackland Prairie,918,895,2013-01-08,23,ES
575,Bluebonnet,637,713,2013-01-08,-76,ES
576,Brushy Creek,797,782,2013-01-08,15,ES
577,C.D. Fulkes,790,741,2013-01-08,49,MS
578,Cactus Ranch,995,951,2013-01-08,44,ES
579,Caldwell Heights,596,646,2013-01-08,-50,ES
580,Callison,870,930,2013-01-08,-60,ES
581,Canyon Creek,435,464,2013-01-08,-29,ES
582,Canyon Vista,1275,1259,2013-01-08,16,MS
583,Caraway,665,689,2013-01-08,-24,ES
584,Cedar Ridge,2820,2979,2013-01-08,-159,HS
585,Cedar Valley,1241,1241,2013-01-08,0,MS
586,Chandler Oaks,624,618,2013-01-08,6,ES
587,Chisholm Trail,1041,1073,2013-01-08,-32,MS
588,Deepwood,416,411,2013-01-08,5,ES
589,Deerpark,932,990,2013-01-08,-58,MS
590,Double File Trail,678,706,2013-01-08,-28,ES
591,DAEP,8,6,2013-01-08,2,Other
592,England,517,516,2013-01-08,1,ES
593,Fern Bluff,762,782,2013-01-08,-20,ES
594,Forest Creek,828,827,2013-01-08,1,ES
595,Forest North,387,399,2013-01-08,-12,ES
596,Gattis,797,779,2013-01-08,18,ES
597,Great Oaks,755,819,2013-01-08,-64,ES
598,Grisham,681,671,2013-01-08,10,MS
599,Hernandez,858,936,2013-01-08,-78,MS
600,Herrington,707,644,2013-01-08,63,ES
601,Hopewell,888,854,2013-01-08,34,MS
602,LOTT,29,22,2013-01-08,7,Other
603,Jollyville,500,550,2013-01-08,-50,ES
604,Laurel Mountain,771,727,2013-01-08,44,ES
605,Live Oak,549,562,2013-01-08,-13,ES
606,McNeil,2376,2450,2013-01-08,-74,HS
607,Old Town,831,834,2013-01-08,-3,ES
608,Pond Springs,650,663,2013-01-08,-13,ES
609,Purple Sage,354,318,2013-01-08,36,ES
610,Round Rock Opportunity Center,107,80,2013-01-08,27,Other
611,Ridgeview,1348,1395,2013-01-08,-47,MS
612,Robertson,530,563,2013-01-08,-33,ES
613,Round Rock,2678,2812,2013-01-08,-134,HS
614,Sommer,818,716,2013-01-08,102,ES
615,Spicewood,733,703,2013-01-08,30,ES
616,Stony Point,2251,2380,2013-01-08,-129,HS
617,Success,141,200,2013-01-08,-59,HS
618,Teravista,766,828,2013-01-08,-62,ES
619,Union Hill,857,856,2013-01-08,1,ES
620,Voigt,626,727,2013-01-08,-101,ES
621,Walsh,1271,1227,2013-01-08,44,MS
622,Wells Branch,907,924,2013-01-08,-17,ES
623,Westwood,2572,2593,2013-01-08,-21,HS
624,Anderson Mill,465,545,2013-01-15,-80,ES
625,Berkman,521,551,2013-01-15,-30,ES
626,Blackland Prairie,920,895,2013-01-15,25,ES
627,Bluebonnet,630,713,2013-01-15,-83,ES
628,Brushy Creek,798,782,2013-01-15,16,ES
629,C.D. Fulkes,795,741,2013-01-15,54,MS
630,Cactus Ranch,994,951,2013-01-15,43,ES
631,Caldwell Heights,602,646,2013-01-15,-44,ES
632,Callison,870,930,2013-01-15,-60,ES
633,Canyon Vista,1275,1259,2013-01-15,16,MS
634,Caraway,668,689,2013-01-15,-21,ES
635,Cedar Ridge,2820,2979,2013-01-15,-159,HS
636,Cedar Valley,1236,1241,2013-01-15,-5,MS
637,Chandler Oaks,621,618,2013-01-15,3,ES
638,Chisholm Trail,1043,1073,2013-01-15,-30,MS
639,Deepwood,413,411,2013-01-15,2,ES
640,Deerpark,932,990,2013-01-15,-58,MS
641,Double File Trail,681,706,2013-01-15,-25,ES
642,DAEP,12,6,2013-01-15,6,Other
643,England,524,516,2013-01-15,8,ES
644,Fern Bluff,761,782,2013-01-15,-21,ES
645,Forest Creek,832,827,2013-01-15,5,ES
646,Forest North,386,399,2013-01-15,-13,ES
647,Gattis,803,779,2013-01-15,24,ES
648,Great Oaks,756,819,2013-01-15,-63,ES
649,Grisham,682,671,2013-01-15,11,MS
650,Hernandez,856,936,2013-01-15,-80,MS
651,Herrington,709,644,2013-01-15,65,ES
652,Hopewell,877,854,2013-01-15,23,MS
653,LOTT,32,22,2013-01-15,10,Other
654,Jollyville,506,550,2013-01-15,-44,ES
655,Laurel Mountain,774,727,2013-01-15,47,ES
656,Live Oak,550,562,2013-01-15,-12,ES
657,McNeil,2380,2450,2013-01-15,-70,HS
658,Old Town,833,834,2013-01-15,-1,ES
659,Pond Springs,649,663,2013-01-15,-14,ES
660,Purple Sage,350,318,2013-01-15,32,ES
661,Round Rock Opportunity Center,87,80,2013-01-15,7,Other
662,Ridgeview,1353,1395,2013-01-15,-42,MS
663,Robertson,528,563,2013-01-15,-35,ES
664,Round Rock,2673,2812,2013-01-15,-139,HS
665,Sommer,818,716,2013-01-15,102,ES
666,Spicewood,734,703,2013-01-15,31,ES
667,Stony Point,2255,2380,2013-01-15,-125,HS
668,Success,158,200,2013-01-15,-42,HS
669,Teravista,771,828,2013-01-15,-57,ES
670,Union Hill,842,856,2013-01-15,-14,ES
671,Voigt,645,727,2013-01-15,-82,ES
672,Walsh,1272,1227,2013-01-15,45,MS
673,Wells Branch,916,924,2013-01-15,-8,ES
674,Westwood,2572,2593,2013-01-15,-21,HS
675,Anderson Mill,463,545,2013-01-22,-82,ES
676,Berkman,523,551,2013-01-22,-28,ES
677,Blackland Prairie,920,895,2013-01-22,25,ES
678,Bluebonnet,628,713,2013-01-22,-85,ES
679,Brushy Creek,796,782,2013-01-22,14,ES
680,C.D. Fulkes,796,741,2013-01-22,55,MS
681,Cactus Ranch,994,951,2013-01-22,43,ES
682,Caldwell Heights,608,646,2013-01-22,-38,ES
683,Callison,866,930,2013-01-22,-64,ES
684,Canyon Creek,438,464,2013-01-22,-26,ES
685,Canyon Vista,1274,1259,2013-01-22,15,MS
686,Caraway,670,689,2013-01-22,-19,ES
687,Cedar Ridge,2821,2979,2013-01-22,-158,HS
688,Cedar Valley,1235,1241,2013-01-22,-6,MS
689,Chandler Oaks,622,618,2013-01-22,4,ES
690,Chisholm Trail,1044,1073,2013-01-22,-29,MS
691,Deepwood,414,411,2013-01-22,3,ES
692,Deerpark,931,990,2013-01-22,-59,MS
693,Double File Trail,681,706,2013-01-22,-25,ES
694,DAEP,12,6,2013-01-22,6,Other
695,England,526,516,2013-01-22,10,ES
696,Fern Bluff,762,782,2013-01-22,-20,ES
697,Forest Creek,830,827,2013-01-22,3,ES
698,Forest North,387,399,2013-01-22,-12,ES
699,Gattis,807,779,2013-01-22,28,ES
700,Great Oaks,758,819,2013-01-22,-61,ES
701,Grisham,681,671,2013-01-22,10,MS
702,Hernandez,861,936,2013-01-22,-75,MS
703,Herrington,708,644,2013-01-22,64,ES
704,Hopewell,883,854,2013-01-22,29,MS
705,LOTT,33,22,2013-01-22,11,Other
706,Jollyville,504,550,2013-01-22,-46,ES
707,Laurel Mountain,775,727,2013-01-22,48,ES
708,Live Oak,548,562,2013-01-22,-14,ES
709,McNeil,2369,2450,2013-01-22,-81,HS
710,Old Town,832,834,2013-01-22,-2,ES
711,Pond Springs,650,663,2013-01-22,-13,ES
712,Purple Sage,348,318,2013-01-22,30,ES
713,Round Rock Opportunity Center,95,80,2013-01-22,15,Other
714,Ridgeview,1356,1395,2013-01-22,-39,MS
715,Robertson,538,563,2013-01-22,-25,ES
716,Round Rock,2664,2812,2013-01-22,-148,HS
717,Sommer,819,716,2013-01-22,103,ES
718,Spicewood,734,703,2013-01-22,31,ES
719,Stony Point,2241,2380,2013-01-22,-139,HS
720,Success,172,200,2013-01-22,-28,HS
721,Teravista,771,828,2013-01-22,-57,ES
722,Union Hill,848,856,2013-01-22,-8,ES
723,Voigt,645,727,2013-01-22,-82,ES
724,Walsh,1269,1227,2013-01-22,42,MS
725,Wells Branch,913,924,2013-01-22,-11,ES
726,Westwood,2567,2593,2013-01-22,-26,HS
727,Anderson Mill,461,545,2013-01-29,-84,ES
728,Berkman,525,551,2013-01-29,-26,ES
729,Blackland Prairie,921,895,2013-01-29,26,ES
730,Bluebonnet,629,713,2013-01-29,-84,ES
731,Brushy Creek,793,782,2013-01-29,11,ES
732,C.D. Fulkes,794,741,2013-01-29,53,MS
733,Cactus Ranch,997,951,2013-01-29,46,ES
734,Caldwell Heights,613,646,2013-01-29,-33,ES
735,Callison,860,930,2013-01-29,-70,ES
736,Canyon Creek,439,464,2013-01-29,-25,ES
737,Canyon Vista,1272,1259,2013-01-29,13,MS
738,Caraway,670,689,2013-01-29,-19,ES
739,Cedar Ridge,2808,2979,2013-01-29,-171,HS
740,Cedar Valley,1238,1241,2013-01-29,-3,MS
741,Chandler Oaks,622,618,2013-01-29,4,ES
742,Chisholm Trail,1046,1073,2013-01-29,-27,MS
743,Deepwood,412,411,2013-01-29,1,ES
744,Deerpark,933,990,2013-01-29,-57,MS
745,Double File Trail,681,706,2013-01-29,-25,ES
746,DAEP,16,6,2013-01-29,10,Other
747,England,528,516,2013-01-29,12,ES
748,Fern Bluff,762,782,2013-01-29,-20,ES
749,Forest Creek,835,827,2013-01-29,8,ES
750,Forest North,392,399,2013-01-29,-7,ES
751,Gattis,804,779,2013-01-29,25,ES
752,Great Oaks,756,819,2013-01-29,-63,ES
753,Grisham,682,671,2013-01-29,11,MS
754,Hernandez,858,936,2013-01-29,-78,MS
755,Herrington,709,644,2013-01-29,65,ES
756,Hopewell,882,854,2013-01-29,28,MS
757,LOTT,32,22,2013-01-29,10,Other
758,Jollyville,506,550,2013-01-29,-44,ES
759,Laurel Mountain,776,727,2013-01-29,49,ES
760,Live Oak,545,562,2013-01-29,-17,ES
761,McNeil,2366,2450,2013-01-29,-84,HS
762,Old Town,833,834,2013-01-29,-1,ES
763,Pond Springs,651,663,2013-01-29,-12,ES
764,Purple Sage,348,318,2013-01-29,30,ES
765,Round Rock Opportunity Center,93,80,2013-01-29,13,Other
766,Ridgeview,1355,1395,2013-01-29,-40,MS
767,Robertson,537,563,2013-01-29,-26,ES
768,Round Rock,2664,2812,2013-01-29,-148,HS
769,Sommer,819,716,2013-01-29,103,ES
770,Spicewood,733,703,2013-01-29,30,ES
771,Stony Point,2244,2380,2013-01-29,-136,HS
772,Success,171,200,2013-01-29,-29,HS
773,Teravista,776,828,2013-01-29,-52,ES
774,Union Hill,851,856,2013-01-29,-5,ES
775,Voigt,644,727,2013-01-29,-83,ES
776,Walsh,1268,1227,2013-01-29,41,MS
777,Wells Branch,919,924,2013-01-29,-5,ES
778,Westwood,2560,2593,2013-01-29,-33,HS
779,Anderson Mill,460,545,2013-02-12,-85,ES
780,Berkman,526,551,2013-02-12,-25,ES
781,Blackland Prairie,921,895,2013-02-12,26,ES
782,Bluebonnet,629,713,2013-02-12,-84,ES
783,Brushy Creek,790,782,2013-02-12,8,ES
784,C.D. Fulkes,791,741,2013-02-12,50,MS
785,Cactus Ranch,998,951,2013-02-12,47,ES
786,Caldwell Heights,608,646,2013-02-12,-38,ES
787,Callison,866,930,2013-02-12,-64,ES
788,Canyon Creek,438,464,2013-02-12,-26,ES
789,Canyon Vista,1272,1259,2013-02-12,13,MS
790,Caraway,670,689,2013-02-12,-19,ES
791,Cedar Ridge,2787,2979,2013-02-12,-192,HS
792,Cedar Valley,1240,1241,2013-02-12,-1,MS
793,Chandler Oaks,620,618,2013-02-12,2,ES
794,Chisholm Trail,1041,1073,2013-02-12,-32,MS
795,Deepwood,417,411,2013-02-12,6,ES
796,Deerpark,933,990,2013-02-12,-57,MS
797,Double File Trail,677,706,2013-02-12,-29,ES
798,DAEP,16,6,2013-02-12,10,Other
799,England,532,516,2013-02-12,16,ES
800,Fern Bluff,762,782,2013-02-12,-20,ES
801,Forest Creek,837,827,2013-02-12,10,ES
802,Forest North,394,399,2013-02-12,-5,ES
803,Gattis,804,779,2013-02-12,25,ES
804,Great Oaks,756,819,2013-02-12,-63,ES
805,Grisham,682,671,2013-02-12,11,MS
806,Hernandez,854,936,2013-02-12,-82,MS
807,Herrington,711,644,2013-02-12,67,ES
808,Hopewell,880,854,2013-02-12,26,MS
809,LOTT,39,22,2013-02-12,17,Other
810,Jollyville,507,550,2013-02-12,-43,ES
811,Laurel Mountain,778,727,2013-02-12,51,ES
812,Live Oak,540,562,2013-02-12,-22,ES
813,McNeil,2359,2450,2013-02-12,-91,HS
814,Old Town,835,834,2013-02-12,1,ES
815,Pond Springs,650,663,2013-02-12,-13,ES
816,Purple Sage,349,318,2013-02-12,31,ES
817,Round Rock Opportunity Center,97,80,2013-02-12,17,Other
818,Ridgeview,1358,1395,2013-02-12,-37,MS
819,Robertson,535,563,2013-02-12,-28,ES
820,Round Rock,2655,2812,2013-02-12,-157,HS
821,Sommer,816,716,2013-02-12,100,ES
822,Spicewood,733,703,2013-02-12,30,ES
823,Stony Point,2238,2380,2013-02-12,-142,HS
824,Success,166,200,2013-02-12,-34,HS
825,Teravista,777,828,2013-02-12,-51,ES
826,Union Hill,847,856,2013-02-12,-9,ES
827,Voigt,645,727,2013-02-12,-82,ES
828,Walsh,1264,1227,2013-02-12,37,MS
829,Wells Branch,920,924,2013-02-12,-4,ES
830,Westwood,2566,2593,2013-02-12,-27,HS
831,Anderson Mill,455,545,2013-02-19,-90,ES
832,Berkman,519,551,2013-02-19,-32,ES
833,Blackland Prairie,920,895,2013-02-19,25,ES
834,Bluebonnet,630,713,2013-02-19,-83,ES
835,Brushy Creek,790,782,2013-02-19,8,ES
836,C.D. Fulkes,792,741,2013-02-19,51,MS
837,Cactus Ranch,998,951,2013-02-19,47,ES
838,Caldwell Heights,607,646,2013-02-19,-39,ES
839,Callison,864,930,2013-02-19,-66,ES
840,Canyon Creek,438,464,2013-02-19,-26,ES
841,Canyon Vista,1271,1259,2013-02-19,12,MS
842,Caraway,669,689,2013-02-19,-20,ES
843,Cedar Ridge,2779,2979,2013-02-19,-200,HS
844,Cedar Valley,1238,1241,2013-02-19,-3,MS
845,Chandler Oaks,621,618,2013-02-19,3,ES
846,Chisholm Trail,1045,1073,2013-02-19,-28,MS
847,Deepwood,419,411,2013-02-19,8,ES
848,Deerpark,934,990,2013-02-19,-56,MS
849,Double File Trail,676,706,2013-02-19,-30,ES
850,DAEP,15,6,2013-02-19,9,Other
851,England,529,516,2013-02-19,13,ES
852,Fern Bluff,762,782,2013-02-19,-20,ES
853,Forest Creek,838,827,2013-02-19,11,ES
854,Forest North,395,399,2013-02-19,-4,ES
855,Gattis,808,779,2013-02-19,29,ES
856,Great Oaks,755,819,2013-02-19,-64,ES
857,Grisham,682,671,2013-02-19,11,MS
858,Hernandez,852,936,2013-02-19,-84,MS
859,Herrington,711,644,2013-02-19,67,ES
860,Hopewell,883,854,2013-02-19,29,MS
861,LOTT,33,22,2013-02-19,11,Other
862,Jollyville,509,550,2013-02-19,-41,ES
863,Laurel Mountain,779,727,2013-02-19,52,ES
864,Live Oak,541,562,2013-02-19,-21,ES
865,McNeil,2360,2450,2013-02-19,-90,HS
866,Old Town,835,834,2013-02-19,1,ES
867,Pond Springs,650,663,2013-02-19,-13,ES
868,Purple Sage,349,318,2013-02-19,31,ES
869,Round Rock Opportunity Center,101,80,2013-02-19,21,Other
870,Ridgeview,1359,1395,2013-02-19,-36,MS
871,Robertson,531,563,2013-02-19,-32,ES
872,Round Rock,2655,2812,2013-02-19,-157,HS
873,Sommer,817,716,2013-02-19,101,ES
874,Spicewood,734,703,2013-02-19,31,ES
875,Stony Point,2237,2380,2013-02-19,-143,HS
876,Success,165,200,2013-02-19,-35,HS
877,Teravista,780,828,2013-02-19,-48,ES
878,Union Hill,840,856,2013-02-19,-16,ES
879,Voigt,647,727,2013-02-19,-80,ES
880,Walsh,1264,1227,2013-02-19,37,MS
881,Wells Branch,912,924,2013-02-19,-12,ES
882,Westwood,2565,2593,2013-02-19,-28,HS
883,Anderson Mill,459,545,2013-02-26,-86,ES
884,Berkman,521,551,2013-02-26,-30,ES
885,Blackland Prairie,919,895,2013-02-26,24,ES
886,Bluebonnet,623,713,2013-02-26,-90,ES
887,Brushy Creek,791,782,2013-02-26,9,ES
888,C.D. Fulkes,782,741,2013-02-26,41,MS
889,Cactus Ranch,999,951,2013-02-26,48,ES
890,Caldwell Heights,605,646,2013-02-26,-41,ES
891,Callison,867,930,2013-02-26,-63,ES
892,Canyon Creek,438,464,2013-02-26,-26,ES
893,Canyon Vista,1274,1259,2013-02-26,15,MS
894,Caraway,671,689,2013-02-26,-18,ES
895,Cedar Ridge,2777,2979,2013-02-26,-202,HS
896,Cedar Valley,1240,1241,2013-02-26,-1,MS
897,Chandler Oaks,621,618,2013-02-26,3,ES
898,Chisholm Trail,1047,1073,2013-02-26,-26,MS
899,Deepwood,420,411,2013-02-26,9,ES
900,Deerpark,928,990,2013-02-26,-62,MS
901,Double File Trail,675,706,2013-02-26,-31,ES
902,DAEP,17,6,2013-02-26,11,Other
903,England,532,516,2013-02-26,16,ES
904,Fern Bluff,763,782,2013-02-26,-19,ES
905,Forest Creek,838,827,2013-02-26,11,ES
906,Forest North,396,399,2013-02-26,-3,ES
907,Gattis,804,779,2013-02-26,25,ES
908,Great Oaks,758,819,2013-02-26,-61,ES
909,Grisham,681,671,2013-02-26,10,MS
910,Hernandez,846,936,2013-02-26,-90,MS
911,Herrington,711,644,2013-02-26,67,ES
912,Hopewell,883,854,2013-02-26,29,MS
913,LOTT,36,22,2013-02-26,14,Other
914,Jollyville,509,550,2013-02-26,-41,ES
915,Laurel Mountain,781,727,2013-02-26,54,ES
916,Live Oak,537,562,2013-02-26,-25,ES
917,McNeil,2346,2450,2013-02-26,-104,HS
918,Old Town,836,834,2013-02-26,2,ES
919,Pond Springs,650,663,2013-02-26,-13,ES
920,Purple Sage,349,318,2013-02-26,31,ES
921,Round Rock Opportunity Center,115,80,2013-02-26,35,Other
922,Ridgeview,1358,1395,2013-02-26,-37,MS
923,Robertson,530,563,2013-02-26,-33,ES
924,Round Rock,2649,2812,2013-02-26,-163,HS
925,Sommer,816,716,2013-02-26,100,ES
926,Spicewood,733,703,2013-02-26,30,ES
927,Stony Point,2229,2380,2013-02-26,-151,HS
928,Success,167,200,2013-02-26,-33,HS
929,Teravista,782,828,2013-02-26,-46,ES
930,Union Hill,839,856,2013-02-26,-17,ES
931,Voigt,649,727,2013-02-26,-78,ES
932,Walsh,1265,1227,2013-02-26,38,MS
933,Wells Branch,912,924,2013-02-26,-12,ES
934,Westwood,2567,2593,2013-02-26,-26,HS
935,Anderson Mill,451,545,2013-04-09,-94,ES
936,Berkman,524,551,2013-04-09,-27,ES
937,Blackland Prairie,924,895,2013-04-09,29,ES
938,Bluebonnet,633,713,2013-04-09,-80,ES
939,Brushy Creek,786,782,2013-04-09,4,ES
940,C.D. Fulkes,773,741,2013-04-09,32,MS
941,Cactus Ranch,1001,951,2013-04-09,50,ES
942,Caldwell Heights,606,646,2013-04-09,-40,ES
943,Callison,877,930,2013-04-09,-53,ES
944,Canyon Creek,445,464,2013-04-09,-19,ES
945,Canyon Vista,1276,1259,2013-04-09,17,MS
946,Caraway,676,689,2013-04-09,-13,ES
947,Cedar Ridge,2744,2979,2013-04-09,-235,HS
948,Cedar Valley,1240,1241,2013-04-09,-1,MS
949,Chandler Oaks,617,618,2013-04-09,-1,ES
950,Chisholm Trail,1055,1073,2013-04-09,-18,MS
951,Deepwood,414,411,2013-04-09,3,ES
952,Deerpark,924,990,2013-04-09,-66,MS
953,Double File Trail,681,706,2013-04-09,-25,ES
954,DAEP,18,6,2013-04-09,12,Other
955,England,539,516,2013-04-09,23,ES
956,Fern Bluff,769,782,2013-04-09,-13,ES
957,Forest Creek,840,827,2013-04-09,13,ES
958,Forest North,397,399,2013-04-09,-2,ES
959,Gattis,810,779,2013-04-09,31,ES
960,Great Oaks,765,819,2013-04-09,-54,ES
961,Grisham,689,671,2013-04-09,18,MS
962,Hernandez,849,936,2013-04-09,-87,MS
963,Herrington,714,644,2013-04-09,70,ES
964,Hopewell,876,854,2013-04-09,22,MS
965,LOTT,34,22,2013-04-09,12,Other
966,Jollyville,513,550,2013-04-09,-37,ES
967,Laurel Mountain,782,727,2013-04-09,55,ES
968,Live Oak,531,562,2013-04-09,-31,ES
969,McNeil,2348,2450,2013-04-09,-102,HS
970,Old Town,838,834,2013-04-09,4,ES
971,Pond Springs,654,663,2013-04-09,-9,ES
972,Purple Sage,347,318,2013-04-09,29,ES
973,Round Rock Opportunity Center,94,80,2013-04-09,14,Other
974,Ridgeview,1357,1395,2013-04-09,-38,MS
975,Robertson,535,563,2013-04-09,-28,ES
976,Round Rock,2623,2812,2013-04-09,-189,HS
977,Sommer,819,716,2013-04-09,103,ES
978,Spicewood,736,703,2013-04-09,33,ES
979,Stony Point,2211,2380,2013-04-09,-169,HS
980,Success,184,200,2013-04-09,-16,HS
981,Teravista,783,828,2013-04-09,-45,ES
982,Union Hill,841,856,2013-04-09,-15,ES
983,Voigt,635,727,2013-04-09,-92,ES
984,Walsh,1265,1227,2013-04-09,38,MS
985,Wells Branch,918,924,2013-04-09,-6,ES
986,Westwood,2560,2593,2013-04-09,-33,HS
987,Anderson Mill,452,545,2013-04-23,-93,ES
988,Berkman,520,551,2013-04-23,-31,ES
989,Blackland Prairie,924,895,2013-04-23,29,ES
990,Bluebonnet,631,713,2013-04-23,-82,ES
991,Brushy Creek,783,782,2013-04-23,1,ES
992,C.D. Fulkes,769,741,2013-04-23,28,MS
993,Cactus Ranch,1003,951,2013-04-23,52,ES
994,Caldwell Heights,609,646,2013-04-23,-37,ES
995,Callison,875,930,2013-04-23,-55,ES
996,Canyon Creek,446,464,2013-04-23,-18,ES
997,Canyon Vista,1277,1259,2013-04-23,18,MS
998,Caraway,675,689,2013-04-23,-14,ES
999,Cedar Ridge,2741,2979,2013-04-23,-238,HS
1000,Cedar Valley,1243,1241,2013-04-23,2,MS
1001,Chandler Oaks,617,618,2013-04-23,-1,ES
1002,Chisholm Trail,1056,1073,2013-04-23,-17,MS
1003,Deepwood,415,411,2013-04-23,4,ES
1004,Deerpark,926,990,2013-04-23,-64,MS
1005,Double File Trail,680,706,2013-04-23,-26,ES
1006,DAEP,13,6,2013-04-23,7,Other
1007,England,541,516,2013-04-23,25,ES
1008,Fern Bluff,769,782,2013-04-23,-13,ES
1009,Forest Creek,837,827,2013-04-23,10,ES
1010,Forest North,393,399,2013-04-23,-6,ES
1011,Gattis,809,779,2013-04-23,30,ES
1012,Great Oaks,765,819,2013-04-23,-54,ES
1013,Grisham,688,671,2013-04-23,17,MS
1014,Hernandez,857,936,2013-04-23,-79,MS
1015,Herrington,715,644,2013-04-23,71,ES
1016,Hopewell,878,854,2013-04-23,24,MS
1017,LOTT,28,22,2013-04-23,6,Other
1018,Jollyville,511,550,2013-04-23,-39,ES
1019,Laurel Mountain,782,727,2013-04-23,55,ES
1020,Live Oak,533,562,2013-04-23,-29,ES
1021,McNeil,2343,2450,2013-04-23,-107,HS
1022,Old Town,841,834,2013-04-23,7,ES
1023,Pond Springs,654,663,2013-04-23,-9,ES
1024,Purple Sage,344,318,2013-04-23,26,ES
1025,Round Rock Opportunity Center,95,80,2013-04-23,15,Other
1026,Ridgeview,1357,1395,2013-04-23,-38,MS
1027,Robertson,537,563,2013-04-23,-26,ES
1028,Round Rock,2617,2812,2013-04-23,-195,HS
1029,Sommer,821,716,2013-04-23,105,ES
1030,Spicewood,735,703,2013-04-23,32,ES
1031,Stony Point,2201,2380,2013-04-23,-179,HS
1032,Success,172,200,2013-04-23,-28,HS
1033,Teravista,779,828,2013-04-23,-49,ES
1034,Union Hill,844,856,2013-04-23,-12,ES
1035,Voigt,638,727,2013-04-23,-89,ES
1036,Walsh,1266,1227,2013-04-23,39,MS
1037,Wells Branch,921,924,2013-04-23,-3,ES
1038,Westwood,2550,2593,2013-04-23,-43,HS
1039,Anderson Mill,465,484,2014-01-07,-19,ES
1040,Berkman,518,544,2014-01-07,-26,ES
1041,Blackland Prairie,878,859,2014-01-07,19,ES
1042,Bluebonnet,572,638,2014-01-07,-66,ES
1043,Brushy Creek,800,762,2014-01-07,38,ES
1044,C.D. Fulkes,779,801,2014-01-07,-22,MS
1045,Cactus Ranch,1055,988,2014-01-07,67,ES
1046,Caldwell Heights,626,598,2014-01-07,28,ES
1047,Callison,872,910,2014-01-07,-38,ES
1048,Canyon Creek,464,426,2014-01-07,38,ES
1049,Canyon Vista,1307,1307,2014-01-07,0,MS
1050,Caraway,686,658,2014-01-07,28,ES
1051,Cedar Ridge,2795,2865,2014-01-07,-70,HS
1052,Cedar Valley,1283,1242,2014-01-07,41,MS
1053,Chandler Oaks,576,641,2014-01-07,-65,ES
1054,Chisholm Trail,1064,1067,2014-01-07,-3,MS
1055,Deepwood,387,411,2014-01-07,-24,ES
1056,Deerpark,925,947,2014-01-07,-22,MS
1057,Double File Trail,710,701,2014-01-07,9,ES
1058,DAEP,8,2,2014-01-07,6,Other
1059,England,751,611,2014-01-07,140,ES
1060,Fern Bluff,720,734,2014-01-07,-14,ES
1061,Forest Creek,850,825,2014-01-07,25,ES
1062,Forest North,415,422,2014-01-07,-7,ES
1063,Gattis,765,809,2014-01-07,-44,ES
1064,Great Oaks,737,735,2014-01-07,2,ES
1065,Grisham,682,672,2014-01-07,10,MS
1066,Hernandez,849,858,2014-01-07,-9,MS
1067,Herrington,780,774,2014-01-07,6,ES
1068,Hopewell,914,900,2014-01-07,14,MS
1069,JJAEP,24,25,2014-01-07,-1,Other
1070,Jollyville,469,509,2014-01-07,-40,ES
1071,Laurel Mountain,793,780,2014-01-07,13,ES
1072,Live Oak,544,586,2014-01-07,-42,ES
1073,McNeil,2458,2463,2014-01-07,-5,HS
1074,Old Town,779,791,2014-01-07,-12,ES
1075,Pond Springs,646,651,2014-01-07,-5,ES
1076,Purple Sage,351,323,2014-01-07,28,ES
1077,Round Rock Opportunity Center,85,58,2014-01-07,27,Other
1078,Ridgeview,1374,1399,2014-01-07,-25,MS
1079,Robertson,517,534,2014-01-07,-17,ES
1080,Round Rock,2860,2893,2014-01-07,-33,HS
1081,Sommer,908,843,2014-01-07,65,ES
1082,Spicewood,768,734,2014-01-07,34,ES
1083,Stony Point,2342,2367,2014-01-07,-25,HS
1084,Success,140,109,2014-01-07,31,HS
1085,Teravista,838,798,2014-01-07,40,ES
1086,Union Hill,850,849,2014-01-07,1,ES
1087,Voigt,606,586,2014-01-07,20,ES
1088,Walsh,1382,1352,2014-01-07,30,MS
1089,Wells Branch,1005,995,2014-01-07,10,ES
1090,Westwood,2623,2624,2014-01-07,-1,HS
1091,Anderson Mill,473,484,2014-01-14,-11,ES
1092,Berkman,525,544,2014-01-14,-19,ES
1093,Blackland Prairie,877,859,2014-01-14,18,ES
1094,Bluebonnet,580,638,2014-01-14,-58,ES
1095,Brushy Creek,812,762,2014-01-14,50,ES
1096,C.D. Fulkes,778,801,2014-01-14,-23,MS
1097,Cactus Ranch,1055,988,2014-01-14,67,ES
1098,Caldwell Heights,622,598,2014-01-14,24,ES
1099,Callison,877,910,2014-01-14,-33,ES
1100,Canyon Creek,464,426,2014-01-14,38,ES
1101,Canyon Vista,1306,1307,2014-01-14,-1,MS
1102,Caraway,687,658,2014-01-14,29,ES
1103,Cedar Ridge,2768,2865,2014-01-14,-97,HS
1104,Cedar Valley,1275,1242,2014-01-14,33,MS
1105,Chandler Oaks,579,641,2014-01-14,-62,ES
1106,Chisholm Trail,1067,1067,2014-01-14,0,MS
1107,Deepwood,388,411,2014-01-14,-23,ES
1108,Deerpark,935,947,2014-01-14,-12,MS
1109,Double File Trail,718,701,2014-01-14,17,ES
1110,DAEP,10,2,2014-01-14,8,Other
1111,England,748,611,2014-01-14,137,ES
1112,Fern Bluff,721,734,2014-01-14,-13,ES
1113,Forest Creek,850,825,2014-01-14,25,ES
1114,Forest North,419,422,2014-01-14,-3,ES
1115,Gattis,765,809,2014-01-14,-44,ES
1116,Great Oaks,738,735,2014-01-14,3,ES
1117,Grisham,686,672,2014-01-14,14,MS
1118,Hernandez,843,858,2014-01-14,-15,MS
1119,Herrington,779,774,2014-01-14,5,ES
1120,Hopewell,903,900,2014-01-14,3,MS
1121,JJAEP,31,25,2014-01-14,6,Other
1122,Jollyville,474,509,2014-01-14,-35,ES
1123,Laurel Mountain,794,780,2014-01-14,14,ES
1124,Live Oak,547,586,2014-01-14,-39,ES
1125,McNeil,2434,2463,2014-01-14,-29,HS
1126,Old Town,780,791,2014-01-14,-11,ES
1127,Pond Springs,647,651,2014-01-14,-4,ES
1128,Purple Sage,351,323,2014-01-14,28,ES
1129,Round Rock Opportunity Center,85,58,2014-01-14,27,Other
1130,Ridgeview,1368,1399,2014-01-14,-31,MS
1131,Robertson,521,534,2014-01-14,-13,ES
1132,Round Rock,2849,2893,2014-01-14,-44,HS
1133,Sommer,915,843,2014-01-14,72,ES
1134,Spicewood,768,734,2014-01-14,34,ES
1135,Stony Point,2333,2367,2014-01-14,-34,HS
1136,Success,153,109,2014-01-14,44,HS
1137,Teravista,825,798,2014-01-14,27,ES
1138,Union Hill,859,849,2014-01-14,10,ES
1139,Voigt,605,586,2014-01-14,19,ES
1140,Walsh,1378,1352,2014-01-14,26,MS
1141,Wells Branch,1001,995,2014-01-14,6,ES
1142,Westwood,2597,2624,2014-01-14,-27,HS
1143,Anderson Mill,473,484,2014-01-21,-11,ES
1144,Berkman,522,544,2014-01-21,-22,ES
1145,Blackland Prairie,879,859,2014-01-21,20,ES
1146,Bluebonnet,576,638,2014-01-21,-62,ES
1147,Brushy Creek,809,762,2014-01-21,47,ES
1148,C.D. Fulkes,779,801,2014-01-21,-22,MS
1149,Cactus Ranch,1057,988,2014-01-21,69,ES
1150,Caldwell Heights,621,598,2014-01-21,23,ES
1151,Callison,878,910,2014-01-21,-32,ES
1152,Canyon Creek,464,426,2014-01-21,38,ES
1153,Canyon Vista,1306,1307,2014-01-21,-1,MS
1154,Caraway,686,658,2014-01-21,28,ES
1155,Cedar Ridge,2770,2865,2014-01-21,-95,HS
1156,Cedar Valley,1272,1242,2014-01-21,30,MS
1157,Chandler Oaks,579,641,2014-01-21,-62,ES
1158,Chisholm Trail,1068,1067,2014-01-21,1,MS
1159,Deepwood,389,411,2014-01-21,-22,ES
1160,Deerpark,936,947,2014-01-21,-11,MS
1161,Double File Trail,716,701,2014-01-21,15,ES
1162,DAEP,10,2,2014-01-21,8,Other
1163,England,748,611,2014-01-21,137,ES
1164,Fern Bluff,721,734,2014-01-21,-13,ES
1165,Forest Creek,849,825,2014-01-21,24,ES
1166,Forest North,421,422,2014-01-21,-1,ES
1167,Gattis,764,809,2014-01-21,-45,ES
1168,Great Oaks,739,735,2014-01-21,4,ES
1169,Grisham,684,672,2014-01-21,12,MS
1170,Hernandez,844,858,2014-01-21,-14,MS
1171,Herrington,777,774,2014-01-21,3,ES
1172,Hopewell,902,900,2014-01-21,2,MS
1173,JJAEP,31,25,2014-01-21,6,Other
1174,Jollyville,475,509,2014-01-21,-34,ES
1175,Laurel Mountain,794,780,2014-01-21,14,ES
1176,Live Oak,548,586,2014-01-21,-38,ES
1177,McNeil,2432,2463,2014-01-21,-31,HS
1178,Old Town,779,791,2014-01-21,-12,ES
1179,Pond Springs,647,651,2014-01-21,-4,ES
1180,Purple Sage,342,323,2014-01-21,19,ES
1181,Round Rock Opportunity Center,81,58,2014-01-21,23,Other
1182,Ridgeview,1366,1399,2014-01-21,-33,MS
1183,Robertson,520,534,2014-01-21,-14,ES
1184,Round Rock,2845,2893,2014-01-21,-48,HS
1185,Sommer,916,843,2014-01-21,73,ES
1186,Spicewood,770,734,2014-01-21,36,ES
1187,Stony Point,2334,2367,2014-01-21,-33,HS
1188,Success,154,109,2014-01-21,45,HS
1189,Teravista,824,798,2014-01-21,26,ES
1190,Union Hill,860,849,2014-01-21,11,ES
1191,Voigt,604,586,2014-01-21,18,ES
1192,Walsh,1379,1352,2014-01-21,27,MS
1193,Wells Branch,1002,995,2014-01-21,7,ES
1194,Westwood,2601,2624,2014-01-21,-23,HS
1195,Anderson Mill,474,484,2014-01-29,-10,ES
1196,Berkman,522,544,2014-01-29,-22,ES
1197,Blackland Prairie,880,859,2014-01-29,21,ES
1198,Bluebonnet,579,638,2014-01-29,-59,ES
1199,Brushy Creek,812,762,2014-01-29,50,ES
1200,C.D. Fulkes,784,801,2014-01-29,-17,MS
1201,Cactus Ranch,1056,988,2014-01-29,68,ES
1202,Caldwell Heights,620,598,2014-01-29,22,ES
1203,Callison,873,910,2014-01-29,-37,ES
1204,Canyon Creek,464,426,2014-01-29,38,ES
1205,Canyon Vista,1308,1307,2014-01-29,1,MS
1206,Caraway,690,658,2014-01-29,32,ES
1207,Cedar Ridge,2758,2865,2014-01-29,-107,HS
1208,Cedar Valley,1273,1242,2014-01-29,31,MS
1209,Chandler Oaks,579,641,2014-01-29,-62,ES
1210,Chisholm Trail,1068,1067,2014-01-29,1,MS
1211,Deepwood,389,411,2014-01-29,-22,ES
1212,Deerpark,934,947,2014-01-29,-13,MS
1213,Double File Trail,718,701,2014-01-29,17,ES
1214,DAEP,10,2,2014-01-29,8,Other
1215,England,748,611,2014-01-29,137,ES
1216,Fern Bluff,721,734,2014-01-29,-13,ES
1217,Forest Creek,848,825,2014-01-29,23,ES
1218,Forest North,422,422,2014-01-29,0,ES
1219,Gattis,766,809,2014-01-29,-43,ES
1220,Great Oaks,737,735,2014-01-29,2,ES
1221,Grisham,683,672,2014-01-29,11,MS
1222,Hernandez,846,858,2014-01-29,-12,MS
1223,Herrington,778,774,2014-01-29,4,ES
1224,Hopewell,902,900,2014-01-29,2,MS
1225,JJAEP,29,25,2014-01-29,4,Other
1226,Jollyville,476,509,2014-01-29,-33,ES
1227,Laurel Mountain,795,780,2014-01-29,15,ES
1228,Live Oak,550,586,2014-01-29,-36,ES
1229,McNeil,2423,2463,2014-01-29,-40,HS
1230,Old Town,777,791,2014-01-29,-14,ES
1231,Pond Springs,646,651,2014-01-29,-5,ES
1232,Purple Sage,343,323,2014-01-29,20,ES
1233,Round Rock Opportunity Center,93,58,2014-01-29,35,Other
1234,Ridgeview,1367,1399,2014-01-29,-32,MS
1235,Robertson,523,534,2014-01-29,-11,ES
1236,Round Rock,2840,2893,2014-01-29,-53,HS
1237,Sommer,914,843,2014-01-29,71,ES
1238,Spicewood,769,734,2014-01-29,35,ES
1239,Stony Point,2329,2367,2014-01-29,-38,HS
1240,Success,158,109,2014-01-29,49,HS
1241,Teravista,819,798,2014-01-29,21,ES
1242,Union Hill,861,849,2014-01-29,12,ES
1243,Voigt,608,586,2014-01-29,22,ES
1244,Walsh,1376,1352,2014-01-29,24,MS
1245,Wells Branch,1006,995,2014-01-29,11,ES
1246,Westwood,2600,2624,2014-01-29,-24,HS
1247,Anderson Mill,475,484,2014-02-04,-9,ES
1248,Berkman,522,544,2014-02-04,-22,ES
1249,Blackland Prairie,877,859,2014-02-04,18,ES
1250,Bluebonnet,578,638,2014-02-04,-60,ES
1251,Brushy Creek,810,762,2014-02-04,48,ES
1252,C.D. Fulkes,783,801,2014-02-04,-18,MS
1253,Cactus Ranch,1058,988,2014-02-04,70,ES
1254,Caldwell Heights,622,598,2014-02-04,24,ES
1255,Callison,869,910,2014-02-04,-41,ES
1256,Canyon Creek,464,426,2014-02-04,38,ES
1257,Canyon Vista,1305,1307,2014-02-04,-2,MS
1258,Caraway,688,658,2014-02-04,30,ES
1259,Cedar Ridge,2752,2865,2014-02-04,-113,HS
1260,Cedar Valley,1273,1242,2014-02-04,31,MS
1261,Chandler Oaks,579,641,2014-02-04,-62,ES
1262,Chisholm Trail,1070,1067,2014-02-04,3,MS
1263,Deepwood,390,411,2014-02-04,-21,ES
1264,Deerpark,934,947,2014-02-04,-13,MS
1265,Double File Trail,707,701,2014-02-04,6,ES
1266,DAEP,13,2,2014-02-04,11,Other
1267,England,744,611,2014-02-04,133,ES
1268,Fern Bluff,722,734,2014-02-04,-12,ES
1269,Forest Creek,850,825,2014-02-04,25,ES
1270,Forest North,421,422,2014-02-04,-1,ES
1271,Gattis,765,809,2014-02-04,-44,ES
1272,Great Oaks,739,735,2014-02-04,4,ES
1273,Grisham,683,672,2014-02-04,11,MS
1274,Hernandez,841,858,2014-02-04,-17,MS
1275,Herrington,778,774,2014-02-04,4,ES
1276,Hopewell,896,900,2014-02-04,-4,MS
1277,JJAEP,29,25,2014-02-04,4,Other
1278,Jollyville,481,509,2014-02-04,-28,ES
1279,Laurel Mountain,796,780,2014-02-04,16,ES
1280,Live Oak,549,586,2014-02-04,-37,ES
1281,McNeil,2419,2463,2014-02-04,-44,HS
1282,Old Town,777,791,2014-02-04,-14,ES
1283,Pond Springs,645,651,2014-02-04,-6,ES
1284,Purple Sage,340,323,2014-02-04,17,ES
1285,Round Rock Opportunity Center,94,58,2014-02-04,36,Other
1286,Ridgeview,1371,1399,2014-02-04,-28,MS
1287,Robertson,522,534,2014-02-04,-12,ES
1288,Round Rock,2838,2893,2014-02-04,-55,HS
1289,Sommer,914,843,2014-02-04,71,ES
1290,Spicewood,769,734,2014-02-04,35,ES
1291,Stony Point,2325,2367,2014-02-04,-42,HS
1292,Success,157,109,2014-02-04,48,HS
1293,Teravista,813,798,2014-02-04,15,ES
1294,Union Hill,857,849,2014-02-04,8,ES
1295,Voigt,608,586,2014-02-04,22,ES
1296,Walsh,1375,1352,2014-02-04,23,MS
1297,Wells Branch,1001,995,2014-02-04,6,ES
1298,Westwood,2598,2624,2014-02-04,-26,HS
1299,Anderson Mill,462,484,2014-02-18,-22,ES
1300,Berkman,524,544,2014-02-18,-20,ES
1301,Blackland Prairie,874,859,2014-02-18,15,ES
1302,Bluebonnet,574,638,2014-02-18,-64,ES
1303,Brushy Creek,810,762,2014-02-18,48,ES
1304,C.D. Fulkes,782,801,2014-02-18,-19,MS
1305,Cactus Ranch,1058,988,2014-02-18,70,ES
1306,Caldwell Heights,612,598,2014-02-18,14,ES
1307,Callison,865,910,2014-02-18,-45,ES
1308,Canyon Creek,463,426,2014-02-18,37,ES
1309,Canyon Vista,1301,1307,2014-02-18,-6,MS
1310,Caraway,693,658,2014-02-18,35,ES
1311,Cedar Ridge,2745,2865,2014-02-18,-120,HS
1312,Cedar Valley,1269,1242,2014-02-18,27,MS
1313,Chandler Oaks,578,641,2014-02-18,-63,ES
1314,Chisholm Trail,1067,1067,2014-02-18,0,MS
1315,Deepwood,389,411,2014-02-18,-22,ES
1316,Deerpark,937,947,2014-02-18,-10,MS
1317,Double File Trail,704,701,2014-02-18,3,ES
1318,DAEP,12,2,2014-02-18,10,Other
1319,England,745,611,2014-02-18,134,ES
1320,Fern Bluff,722,734,2014-02-18,-12,ES
1321,Forest Creek,848,825,2014-02-18,23,ES
1322,Forest North,426,422,2014-02-18,4,ES
1323,Gattis,763,809,2014-02-18,-46,ES
1324,Great Oaks,741,735,2014-02-18,6,ES
1325,Grisham,687,672,2014-02-18,15,MS
1326,Hernandez,844,858,2014-02-18,-14,MS
1327,Herrington,777,774,2014-02-18,3,ES
1328,Hopewell,901,900,2014-02-18,1,MS
1329,JJAEP,30,25,2014-02-18,5,Other
1330,Jollyville,482,509,2014-02-18,-27,ES
1331,Laurel Mountain,795,780,2014-02-18,15,ES
1332,Live Oak,546,586,2014-02-18,-40,ES
1333,McNeil,2406,2463,2014-02-18,-57,HS
1334,Old Town,778,791,2014-02-18,-13,ES
1335,Pond Springs,648,651,2014-02-18,-3,ES
1336,Purple Sage,338,323,2014-02-18,15,ES
1337,Round Rock Opportunity Center,109,58,2014-02-18,51,Other
1338,Ridgeview,1372,1399,2014-02-18,-27,MS
1339,Robertson,522,534,2014-02-18,-12,ES
1340,Round Rock,2832,2893,2014-02-18,-61,HS
1341,Sommer,918,843,2014-02-18,75,ES
1342,Spicewood,767,734,2014-02-18,33,ES
1343,Stony Point,2305,2367,2014-02-18,-62,HS
1344,Success,168,109,2014-02-18,59,HS
1345,Teravista,812,798,2014-02-18,14,ES
1346,Union Hill,855,849,2014-02-18,6,ES
1347,Voigt,612,586,2014-02-18,26,ES
1348,Walsh,1377,1352,2014-02-18,25,MS
1349,Wells Branch,1004,995,2014-02-18,9,ES
1350,Westwood,2592,2624,2014-02-18,-32,HS
1351,Anderson Mill,462,484,2014-02-25,-22,ES
1352,Berkman,528,544,2014-02-25,-16,ES
1353,Blackland Prairie,875,859,2014-02-25,16,ES
1354,Bluebonnet,572,638,2014-02-25,-66,ES
1355,Brushy Creek,813,762,2014-02-25,51,ES
1356,C.D. Fulkes,777,801,2014-02-25,-24,MS
1357,Cactus Ranch,1057,988,2014-02-25,69,ES
1358,Caldwell Heights,611,598,2014-02-25,13,ES
1359,Callison,868,910,2014-02-25,-42,ES
1360,Canyon Creek,463,426,2014-02-25,37,ES
1361,Canyon Vista,1302,1307,2014-02-25,-5,MS
1362,Caraway,697,658,2014-02-25,39,ES
1363,Cedar Ridge,2747,2865,2014-02-25,-118,HS
1364,Cedar Valley,1269,1242,2014-02-25,27,MS
1365,Chandler Oaks,578,641,2014-02-25,-63,ES
1366,Chisholm Trail,1067,1067,2014-02-25,0,MS
1367,Deepwood,389,411,2014-02-25,-22,ES
1368,Deerpark,934,947,2014-02-25,-13,MS
1369,Double File Trail,699,701,2014-02-25,-2,ES
1370,DAEP,14,2,2014-02-25,12,Other
1371,England,744,611,2014-02-25,133,ES
1372,Fern Bluff,726,734,2014-02-25,-8,ES
1373,Forest Creek,848,825,2014-02-25,23,ES
1374,Forest North,426,422,2014-02-25,4,ES
1375,Gattis,763,809,2014-02-25,-46,ES
1376,Great Oaks,741,735,2014-02-25,6,ES
1377,Grisham,688,672,2014-02-25,16,MS
1378,Hernandez,847,858,2014-02-25,-11,MS
1379,Herrington,779,774,2014-02-25,5,ES
1380,Hopewell,903,900,2014-02-25,3,MS
1381,JJAEP,29,25,2014-02-25,4,Other
1382,Jollyville,484,509,2014-02-25,-25,ES
1383,Laurel Mountain,794,780,2014-02-25,14,ES
1384,Live Oak,548,586,2014-02-25,-38,ES
1385,McNeil,2408,2463,2014-02-25,-55,HS
1386,Old Town,777,791,2014-02-25,-14,ES
1387,Pond Springs,649,651,2014-02-25,-2,ES
1388,Purple Sage,339,323,2014-02-25,16,ES
1389,Round Rock Opportunity Center,108,58,2014-02-25,50,Other
1390,Ridgeview,1368,1399,2014-02-25,-31,MS
1391,Robertson,524,534,2014-02-25,-10,ES
1392,Round Rock,2830,2893,2014-02-25,-63,HS
1393,Sommer,917,843,2014-02-25,74,ES
1394,Spicewood,766,734,2014-02-25,32,ES
1395,Stony Point,2306,2367,2014-02-25,-61,HS
1396,Success,154,109,2014-02-25,45,HS
1397,Teravista,813,798,2014-02-25,15,ES
1398,Union Hill,849,849,2014-02-25,0,ES
1399,Voigt,608,586,2014-02-25,22,ES
1400,Walsh,1374,1352,2014-02-25,22,MS
1401,Wells Branch,1000,995,2014-02-25,5,ES
1402,Westwood,2598,2624,2014-02-25,-26,HS
1403,Anderson Mill,460,484,2014-03-04,-24,ES
1404,Berkman,526,544,2014-03-04,-18,ES
1405,Blackland Prairie,875,859,2014-03-04,16,ES
1406,Bluebonnet,575,638,2014-03-04,-63,ES
1407,Brushy Creek,815,762,2014-03-04,53,ES
1408,C.D. Fulkes,779,801,2014-03-04,-22,MS
1409,Cactus Ranch,1058,988,2014-03-04,70,ES
1410,Caldwell Heights,613,598,2014-03-04,15,ES
1411,Callison,862,910,2014-03-04,-48,ES
1412,Canyon Creek,463,426,2014-03-04,37,ES
1413,Canyon Vista,1301,1307,2014-03-04,-6,MS
1414,Caraway,697,658,2014-03-04,39,ES
1415,Cedar Ridge,2747,2865,2014-03-04,-118,HS
1416,Cedar Valley,1272,1242,2014-03-04,30,MS
1417,Chandler Oaks,580,641,2014-03-04,-61,ES
1418,Chisholm Trail,1061,1067,2014-03-04,-6,MS
1419,Deepwood,390,411,2014-03-04,-21,ES
1420,Deerpark,933,947,2014-03-04,-14,MS
1421,Double File Trail,701,701,2014-03-04,0,ES
1422,DAEP,12,2,2014-03-04,10,Other
1423,England,746,611,2014-03-04,135,ES
1424,Fern Bluff,726,734,2014-03-04,-8,ES
1425,Forest Creek,850,825,2014-03-04,25,ES
1426,Forest North,425,422,2014-03-04,3,ES
1427,Gattis,763,809,2014-03-04,-46,ES
1428,Great Oaks,741,735,2014-03-04,6,ES
1429,Grisham,690,672,2014-03-04,18,MS
1430,Hernandez,847,858,2014-03-04,-11,MS
1431,Herrington,781,774,2014-03-04,7,ES
1432,Hopewell,903,900,2014-03-04,3,MS
1433,JJAEP,31,25,2014-03-04,6,Other
1434,Jollyville,487,509,2014-03-04,-22,ES
1435,Laurel Mountain,793,780,2014-03-04,13,ES
1436,Live Oak,546,586,2014-03-04,-40,ES
1437,McNeil,2401,2463,2014-03-04,-62,HS
1438,Old Town,775,791,2014-03-04,-16,ES
1439,Pond Springs,648,651,2014-03-04,-3,ES
1440,Purple Sage,338,323,2014-03-04,15,ES
1441,Round Rock Opportunity Center,110,58,2014-03-04,52,Other
1442,Ridgeview,1367,1399,2014-03-04,-32,MS
1443,Robertson,524,534,2014-03-04,-10,ES
1444,Round Rock,2829,2893,2014-03-04,-64,HS
1445,Sommer,917,843,2014-03-04,74,ES
1446,Spicewood,766,734,2014-03-04,32,ES
1447,Stony Point,2301,2367,2014-03-04,-66,HS
1448,Success,152,109,2014-03-04,43,HS
1449,Teravista,812,798,2014-03-04,14,ES
1450,Union Hill,852,849,2014-03-04,3,ES
1451,Voigt,608,586,2014-03-04,22,ES
1452,Walsh,1374,1352,2014-03-04,22,MS
1453,Wells Branch,1002,995,2014-03-04,7,ES
1454,Westwood,2596,2624,2014-03-04,-28,HS
1455,Anderson Mill,460,484,2014-03-18,-24,ES
1456,Berkman,525,544,2014-03-18,-19,ES
1457,Blackland Prairie,876,859,2014-03-18,17,ES
1458,Bluebonnet,577,638,2014-03-18,-61,ES
1459,Brushy Creek,820,762,2014-03-18,58,ES
1460,C.D. Fulkes,780,801,2014-03-18,-21,MS
1461,Cactus Ranch,1058,988,2014-03-18,70,ES
1462,Caldwell Heights,623,598,2014-03-18,25,ES
1463,Callison,865,910,2014-03-18,-45,ES
1464,Canyon Creek,463,426,2014-03-18,37,ES
1465,Canyon Vista,1301,1307,2014-03-18,-6,MS
1466,Caraway,699,658,2014-03-18,41,ES
1467,Cedar Ridge,2743,2865,2014-03-18,-122,HS
1468,Cedar Valley,1273,1242,2014-03-18,31,MS
1469,Chandler Oaks,578,641,2014-03-18,-63,ES
1470,Chisholm Trail,1064,1067,2014-03-18,-3,MS
1471,Deepwood,388,411,2014-03-18,-23,ES
1472,Deerpark,937,947,2014-03-18,-10,MS
1473,Double File Trail,702,701,2014-03-18,1,ES
1474,DAEP,8,2,2014-03-18,6,Other
1475,England,747,611,2014-03-18,136,ES
1476,Fern Bluff,727,734,2014-03-18,-7,ES
1477,Forest Creek,853,825,2014-03-18,28,ES
1478,Forest North,430,422,2014-03-18,8,ES
1479,Gattis,764,809,2014-03-18,-45,ES
1480,Great Oaks,741,735,2014-03-18,6,ES
1481,Grisham,696,672,2014-03-18,24,MS
1482,Hernandez,855,858,2014-03-18,-3,MS
1483,Herrington,787,774,2014-03-18,13,ES
1484,Hopewell,901,900,2014-03-18,1,MS
1485,JJAEP,34,25,2014-03-18,9,Other
1486,Jollyville,486,509,2014-03-18,-23,ES
1487,Laurel Mountain,793,780,2014-03-18,13,ES
1488,Live Oak,550,586,2014-03-18,-36,ES
1489,McNeil,2395,2463,2014-03-18,-68,HS
1490,Old Town,774,791,2014-03-18,-17,ES
1491,Pond Springs,649,651,2014-03-18,-2,ES
1492,Purple Sage,340,323,2014-03-18,17,ES
1493,Round Rock Opportunity Center,100,58,2014-03-18,42,Other
1494,Ridgeview,1367,1399,2014-03-18,-32,MS
1495,Robertson,527,534,2014-03-18,-7,ES
1496,Round Rock,2818,2893,2014-03-18,-75,HS
1497,Sommer,916,843,2014-03-18,73,ES
1498,Spicewood,764,734,2014-03-18,30,ES
1499,Stony Point,2301,2367,2014-03-18,-66,HS
1500,Success,171,109,2014-03-18,62,HS
1501,Teravista,821,798,2014-03-18,23,ES
1502,Union Hill,853,849,2014-03-18,4,ES
1503,Voigt,610,586,2014-03-18,24,ES
1504,Walsh,1369,1352,2014-03-18,17,MS
1505,Wells Branch,1003,995,2014-03-18,8,ES
1506,Westwood,2595,2624,2014-03-18,-29,HS
1507,Anderson Mill,461,484,2014-03-25,-23,ES
1508,Berkman,522,544,2014-03-25,-22,ES
1509,Blackland Prairie,876,859,2014-03-25,17,ES
1510,Bluebonnet,575,638,2014-03-25,-63,ES
1511,Brushy Creek,820,762,2014-03-25,58,ES
1512,C.D. Fulkes,786,801,2014-03-25,-15,MS
1513,Cactus Ranch,1053,988,2014-03-25,65,ES
1514,Caldwell Heights,628,598,2014-03-25,30,ES
1515,Callison,865,910,2014-03-25,-45,ES
1516,Canyon Creek,463,426,2014-03-25,37,ES
1517,Canyon Vista,1302,1307,2014-03-25,-5,MS
1518,Caraway,694,658,2014-03-25,36,ES
1519,Cedar Ridge,2741,2865,2014-03-25,-124,HS
1520,Cedar Valley,1273,1242,2014-03-25,31,MS
1521,Chandler Oaks,577,641,2014-03-25,-64,ES
1522,Chisholm Trail,1065,1067,2014-03-25,-2,MS
1523,Deepwood,391,411,2014-03-25,-20,ES
1524,Deerpark,941,947,2014-03-25,-6,MS
1525,Double File Trail,700,701,2014-03-25,-1,ES
1526,DAEP,8,2,2014-03-25,6,Other
1527,England,747,611,2014-03-25,136,ES
1528,Fern Bluff,726,734,2014-03-25,-8,ES
1529,Forest Creek,854,825,2014-03-25,29,ES
1530,Forest North,426,422,2014-03-25,4,ES
1531,Gattis,763,809,2014-03-25,-46,ES
1532,Great Oaks,742,735,2014-03-25,7,ES
1533,Grisham,695,672,2014-03-25,23,MS
1534,Hernandez,849,858,2014-03-25,-9,MS
1535,Herrington,792,774,2014-03-25,18,ES
1536,Hopewell,901,900,2014-03-25,1,MS
1537,JJAEP,35,25,2014-03-25,10,Other
1538,Jollyville,489,509,2014-03-25,-20,ES
1539,Laurel Mountain,794,780,2014-03-25,14,ES
1540,Live Oak,556,586,2014-03-25,-30,ES
1541,McNeil,2392,2463,2014-03-25,-71,HS
1542,Old Town,774,791,2014-03-25,-17,ES
1543,Pond Springs,649,651,2014-03-25,-2,ES
1544,Purple Sage,338,323,2014-03-25,15,ES
1545,Round Rock Opportunity Center,87,58,2014-03-25,29,Other
1546,Ridgeview,1367,1399,2014-03-25,-32,MS
1547,Robertson,525,534,2014-03-25,-9,ES
1548,Round Rock,2815,2893,2014-03-25,-78,HS
1549,Sommer,914,843,2014-03-25,71,ES
1550,Spicewood,763,734,2014-03-25,29,ES
1551,Stony Point,2292,2367,2014-03-25,-75,HS
1552,Success,177,109,2014-03-25,68,HS
1553,Teravista,819,798,2014-03-25,21,ES
1554,Union Hill,847,849,2014-03-25,-2,ES
1555,Voigt,612,586,2014-03-25,26,ES
1556,Walsh,1365,1352,2014-03-25,13,MS
1557,Wells Branch,1005,995,2014-03-25,10,ES
1558,Westwood,2590,2624,2014-03-25,-34,HS
1559,Anderson Mill,463,484,2014-04-01,-21,ES
1560,Berkman,515,544,2014-04-01,-29,ES
1561,Blackland Prairie,875,859,2014-04-01,16,ES
1562,Bluebonnet,571,638,2014-04-01,-67,ES
1563,Brushy Creek,820,762,2014-04-01,58,ES
1564,C.D. Fulkes,784,801,2014-04-01,-17,MS
1565,Cactus Ranch,1053,988,2014-04-01,65,ES
1566,Caldwell Heights,627,598,2014-04-01,29,ES
1567,Callison,856,910,2014-04-01,-54,ES
1568,Canyon Creek,463,426,2014-04-01,37,ES
1569,Canyon Vista,1303,1307,2014-04-01,-4,MS
1570,Caraway,695,658,2014-04-01,37,ES
1571,Cedar Ridge,2736,2865,2014-04-01,-129,HS
1572,Cedar Valley,1271,1242,2014-04-01,29,MS
1573,Chandler Oaks,578,641,2014-04-01,-63,ES
1574,Chisholm Trail,1066,1067,2014-04-01,-1,MS
1575,Deepwood,392,411,2014-04-01,-19,ES
1576,Deerpark,938,947,2014-04-01,-9,MS
1577,Double File Trail,701,701,2014-04-01,0,ES
1578,DAEP,9,2,2014-04-01,7,Other
1579,England,747,611,2014-04-01,136,ES
1580,Fern Bluff,726,734,2014-04-01,-8,ES
1581,Forest Creek,855,825,2014-04-01,30,ES
1582,Forest North,424,422,2014-04-01,2,ES
1583,Gattis,762,809,2014-04-01,-47,ES
1584,Great Oaks,743,735,2014-04-01,8,ES
1585,Grisham,695,672,2014-04-01,23,MS
1586,Hernandez,848,858,2014-04-01,-10,MS
1587,Herrington,791,774,2014-04-01,17,ES
1588,Hopewell,902,900,2014-04-01,2,MS
1589,JJAEP,37,25,2014-04-01,12,Other
1590,Jollyville,487,509,2014-04-01,-22,ES
1591,Laurel Mountain,797,780,2014-04-01,17,ES
1592,Live Oak,553,586,2014-04-01,-33,ES
1593,McNeil,2389,2463,2014-04-01,-74,HS
1594,Old Town,777,791,2014-04-01,-14,ES
1595,Pond Springs,651,651,2014-04-01,0,ES
1596,Purple Sage,336,323,2014-04-01,13,ES
1597,Round Rock Opportunity Center,90,58,2014-04-01,32,Other
1598,Ridgeview,1366,1399,2014-04-01,-33,MS
1599,Robertson,525,534,2014-04-01,-9,ES
1600,Round Rock,2813,2893,2014-04-01,-80,HS
1601,Sommer,914,843,2014-04-01,71,ES
1602,Spicewood,764,734,2014-04-01,30,ES
1603,Stony Point,2290,2367,2014-04-01,-77,HS
1604,Success,174,109,2014-04-01,65,HS
1605,Teravista,820,798,2014-04-01,22,ES
1606,Union Hill,845,849,2014-04-01,-4,ES
1607,Voigt,612,586,2014-04-01,26,ES
1608,Walsh,1366,1352,2014-04-01,14,MS
1609,Wells Branch,1001,995,2014-04-01,6,ES
1610,Westwood,2582,2624,2014-04-01,-42,HS
1611,Anderson Mill,461,484,2014-04-08,-23,ES
1612,Berkman,515,544,2014-04-08,-29,ES
1613,Blackland Prairie,877,859,2014-04-08,18,ES
1614,Bluebonnet,574,638,2014-04-08,-64,ES
1615,Brushy Creek,823,762,2014-04-08,61,ES
1616,C.D. Fulkes,788,801,2014-04-08,-13,MS
1617,Cactus Ranch,1053,988,2014-04-08,65,ES
1618,Caldwell Heights,626,598,2014-04-08,28,ES
1619,Callison,855,910,2014-04-08,-55,ES
1620,Canyon Creek,461,426,2014-04-08,35,ES
1621,Canyon Vista,1303,1307,2014-04-08,-4,MS
1622,Caraway,693,658,2014-04-08,35,ES
1623,Cedar Ridge,2729,2865,2014-04-08,-136,HS
1624,Cedar Valley,1271,1242,2014-04-08,29,MS
1625,Chandler Oaks,575,641,2014-04-08,-66,ES
1626,Chisholm Trail,1072,1067,2014-04-08,5,MS
1627,Deepwood,391,411,2014-04-08,-20,ES
1628,Deerpark,933,947,2014-04-08,-14,MS
1629,Double File Trail,699,701,2014-04-08,-2,ES
1630,DAEP,8,2,2014-04-08,6,Other
1631,England,749,611,2014-04-08,138,ES
1632,Fern Bluff,725,734,2014-04-08,-9,ES
1633,Forest Creek,854,825,2014-04-08,29,ES
1634,Forest North,426,422,2014-04-08,4,ES
1635,Gattis,764,809,2014-04-08,-45,ES
1636,Great Oaks,746,735,2014-04-08,11,ES
1637,Grisham,693,672,2014-04-08,21,MS
1638,Hernandez,847,858,2014-04-08,-11,MS
1639,Herrington,791,774,2014-04-08,17,ES
1640,Hopewell,905,900,2014-04-08,5,MS
1641,JJAEP,42,25,2014-04-08,17,Other
1642,Jollyville,484,509,2014-04-08,-25,ES
1643,Laurel Mountain,799,780,2014-04-08,19,ES
1644,Live Oak,554,586,2014-04-08,-32,ES
1645,McNeil,2387,2463,2014-04-08,-76,HS
1646,Old Town,775,791,2014-04-08,-16,ES
1647,Pond Springs,650,651,2014-04-08,-1,ES
1648,Purple Sage,336,323,2014-04-08,13,ES
1649,Round Rock Opportunity Center,87,58,2014-04-08,29,Other
1650,Ridgeview,1363,1399,2014-04-08,-36,MS
1651,Robertson,522,534,2014-04-08,-12,ES
1652,Round Rock,2809,2893,2014-04-08,-84,HS
1653,Sommer,916,843,2014-04-08,73,ES
1654,Spicewood,761,734,2014-04-08,27,ES
1655,Stony Point,2293,2367,2014-04-08,-74,HS
1656,Success,163,109,2014-04-08,54,HS
1657,Teravista,821,798,2014-04-08,23,ES
1658,Union Hill,844,849,2014-04-08,-5,ES
1659,Voigt,613,586,2014-04-08,27,ES
1660,Walsh,1365,1352,2014-04-08,13,MS
1661,Wells Branch,1003,995,2014-04-08,8,ES
1662,Westwood,2579,2624,2014-04-08,-45,HS
1663,Anderson Mill,461,484,2014-04-15,-23,ES
1664,Berkman,513,544,2014-04-15,-31,ES
1665,Blackland Prairie,877,859,2014-04-15,18,ES
1666,Bluebonnet,574,638,2014-04-15,-64,ES
1667,Brushy Creek,819,762,2014-04-15,57,ES
1668,C.D. Fulkes,787,801,2014-04-15,-14,MS
1669,Cactus Ranch,1054,988,2014-04-15,66,ES
1670,Caldwell Heights,627,598,2014-04-15,29,ES
1671,Callison,857,910,2014-04-15,-53,ES
1672,Canyon Creek,461,426,2014-04-15,35,ES
1673,Canyon Vista,1303,1307,2014-04-15,-4,MS
1674,Caraway,693,658,2014-04-15,35,ES
1675,Cedar Ridge,2733,2865,2014-04-15,-132,HS
1676,Cedar Valley,1272,1242,2014-04-15,30,MS
1677,Chandler Oaks,575,641,2014-04-15,-66,ES
1678,Chisholm Trail,1074,1067,2014-04-15,7,MS
1679,Deepwood,392,411,2014-04-15,-19,ES
1680,Deerpark,932,947,2014-04-15,-15,MS
1681,Double File Trail,702,701,2014-04-15,1,ES
1682,DAEP,9,2,2014-04-15,7,Other
1683,England,748,611,2014-04-15,137,ES
1684,Fern Bluff,724,734,2014-04-15,-10,ES
1685,Forest Creek,854,825,2014-04-15,29,ES
1686,Forest North,424,422,2014-04-15,2,ES
1687,Gattis,766,809,2014-04-15,-43,ES
1688,Great Oaks,749,735,2014-04-15,14,ES
1689,Grisham,692,672,2014-04-15,20,MS
1690,Hernandez,846,858,2014-04-15,-12,MS
1691,Herrington,793,774,2014-04-15,19,ES
1692,Hopewell,905,900,2014-04-15,5,MS
1693,JJAEP,44,25,2014-04-15,19,Other
1694,Jollyville,485,509,2014-04-15,-24,ES
1695,Laurel Mountain,799,780,2014-04-15,19,ES
1696,Live Oak,559,586,2014-04-15,-27,ES
1697,McNeil,2385,2463,2014-04-15,-78,HS
1698,Old Town,774,791,2014-04-15,-17,ES
1699,Pond Springs,649,651,2014-04-15,-2,ES
1700,Purple Sage,339,323,2014-04-15,16,ES
1701,Round Rock Opportunity Center,87,58,2014-04-15,29,Other
1702,Ridgeview,1365,1399,2014-04-15,-34,MS
1703,Robertson,517,534,2014-04-15,-17,ES
1704,Round Rock,2806,2893,2014-04-15,-87,HS
1705,Sommer,915,843,2014-04-15,72,ES
1706,Spicewood,763,734,2014-04-15,29,ES
1707,Stony Point,2297,2367,2014-04-15,-70,HS
1708,Success,158,109,2014-04-15,49,HS
1709,Teravista,825,798,2014-04-15,27,ES
1710,Union Hill,844,849,2014-04-15,-5,ES
1711,Voigt,615,586,2014-04-15,29,ES
1712,Walsh,1368,1352,2014-04-15,16,MS
1713,Wells Branch,1003,995,2014-04-15,8,ES
1714,Westwood,2575,2624,2014-04-15,-49,HS
1715,Anderson Mill,462,484,2014-04-22,-22,ES
1716,Berkman,515,544,2014-04-22,-29,ES
1717,Blackland Prairie,877,859,2014-04-22,18,ES
1718,Bluebonnet,575,638,2014-04-22,-63,ES
1719,Brushy Creek,820,762,2014-04-22,58,ES
1720,C.D. Fulkes,786,801,2014-04-22,-15,MS
1721,Cactus Ranch,1056,988,2014-04-22,68,ES
1722,Caldwell Heights,628,598,2014-04-22,30,ES
1723,Callison,853,910,2014-04-22,-57,ES
1724,Canyon Creek,458,426,2014-04-22,32,ES
1725,Canyon Vista,1302,1307,2014-04-22,-5,MS
1726,Caraway,693,658,2014-04-22,35,ES
1727,Cedar Ridge,2731,2865,2014-04-22,-134,HS
1728,Cedar Valley,1272,1242,2014-04-22,30,MS
1729,Chandler Oaks,576,641,2014-04-22,-65,ES
1730,Chisholm Trail,1077,1067,2014-04-22,10,MS
1731,Deepwood,394,411,2014-04-22,-17,ES
1732,Deerpark,931,947,2014-04-22,-16,MS
1733,Double File Trail,702,701,2014-04-22,1,ES
1734,DAEP,9,2,2014-04-22,7,Other
1735,England,748,611,2014-04-22,137,ES
1736,Fern Bluff,726,734,2014-04-22,-8,ES
1737,Forest Creek,853,825,2014-04-22,28,ES
1738,Forest North,426,422,2014-04-22,4,ES
1739,Gattis,764,809,2014-04-22,-45,ES
1740,Great Oaks,750,735,2014-04-22,15,ES
1741,Grisham,691,672,2014-04-22,19,MS
1742,Hernandez,846,858,2014-04-22,-12,MS
1743,Herrington,791,774,2014-04-22,17,ES
1744,Hopewell,907,900,2014-04-22,7,MS
1745,JJAEP,42,25,2014-04-22,17,Other
1746,Jollyville,486,509,2014-04-22,-23,ES
1747,Laurel Mountain,799,780,2014-04-22,19,ES
1748,Live Oak,562,586,2014-04-22,-24,ES
1749,McNeil,2385,2463,2014-04-22,-78,HS
1750,Old Town,777,791,2014-04-22,-14,ES
1751,Pond Springs,647,651,2014-04-22,-4,ES
1752,Purple Sage,337,323,2014-04-22,14,ES
1753,Round Rock Opportunity Center,90,58,2014-04-22,32,Other
1754,Ridgeview,1364,1399,2014-04-22,-35,MS
1755,Robertson,517,534,2014-04-22,-17,ES
1756,Round Rock,2807,2893,2014-04-22,-86,HS
1757,Sommer,918,843,2014-04-22,75,ES
1758,Spicewood,763,734,2014-04-22,29,ES
1759,Stony Point,2294,2367,2014-04-22,-73,HS
1760,Success,151,109,2014-04-22,42,HS
1761,Teravista,827,798,2014-04-22,29,ES
1762,Union Hill,842,849,2014-04-22,-7,ES
1763,Voigt,615,586,2014-04-22,29,ES
1764,Walsh,1368,1352,2014-04-22,16,MS
1765,Wells Branch,999,995,2014-04-22,4,ES
1766,Westwood,2574,2624,2014-04-22,-50,HS
1767,Anderson Mill,457,484,2014-04-29,-27,ES
1768,Berkman,521,544,2014-04-29,-23,ES
1769,Blackland Prairie,877,859,2014-04-29,18,ES
1770,Bluebonnet,576,638,2014-04-29,-62,ES
1771,Brushy Creek,821,762,2014-04-29,59,ES
1772,C.D. Fulkes,786,801,2014-04-29,-15,MS
1773,Cactus Ranch,1052,988,2014-04-29,64,ES
1774,Caldwell Heights,631,598,2014-04-29,33,ES
1775,Callison,851,910,2014-04-29,-59,ES
1776,Canyon Creek,458,426,2014-04-29,32,ES
1777,Canyon Vista,1302,1307,2014-04-29,-5,MS
1778,Caraway,693,658,2014-04-29,35,ES
1779,Cedar Ridge,2714,2865,2014-04-29,-151,HS
1780,Cedar Valley,1275,1242,2014-04-29,33,MS
1781,Chandler Oaks,576,641,2014-04-29,-65,ES
1782,Chisholm Trail,1081,1067,2014-04-29,14,MS
1783,Deepwood,396,411,2014-04-29,-15,ES
1784,Deerpark,933,947,2014-04-29,-14,MS
1785,Double File Trail,701,701,2014-04-29,0,ES
1786,DAEP,8,2,2014-04-29,6,Other
1787,England,750,611,2014-04-29,139,ES
1788,Fern Bluff,726,734,2014-04-29,-8,ES
1789,Forest Creek,854,825,2014-04-29,29,ES
1790,Forest North,427,422,2014-04-29,5,ES
1791,Gattis,766,809,2014-04-29,-43,ES
1792,Great Oaks,751,735,2014-04-29,16,ES
1793,Grisham,692,672,2014-04-29,20,MS
1794,Hernandez,846,858,2014-04-29,-12,MS
1795,Herrington,792,774,2014-04-29,18,ES
1796,Hopewell,907,900,2014-04-29,7,MS
1797,JJAEP,44,25,2014-04-29,19,Other
1798,Jollyville,487,509,2014-04-29,-22,ES
1799,Laurel Mountain,800,780,2014-04-29,20,ES
1800,Live Oak,560,586,2014-04-29,-26,ES
1801,McNeil,2380,2463,2014-04-29,-83,HS
1802,Old Town,776,791,2014-04-29,-15,ES
1803,Pond Springs,645,651,2014-04-29,-6,ES
1804,Purple Sage,338,323,2014-04-29,15,ES
1805,Round Rock Opportunity Center,91,58,2014-04-29,33,Other
1806,Ridgeview,1362,1399,2014-04-29,-37,MS
1807,Robertson,520,534,2014-04-29,-14,ES
1808,Round Rock,2799,2893,2014-04-29,-94,HS
1809,Sommer,918,843,2014-04-29,75,ES
1810,Spicewood,763,734,2014-04-29,29,ES
1811,Stony Point,2287,2367,2014-04-29,-80,HS
1812,Success,172,109,2014-04-29,63,HS
1813,Teravista,825,798,2014-04-29,27,ES
1814,Union Hill,839,849,2014-04-29,-10,ES
1815,Voigt,611,586,2014-04-29,25,ES
1816,Walsh,1369,1352,2014-04-29,17,MS
1817,Wells Branch,1001,995,2014-04-29,6,ES
1818,Westwood,2571,2624,2014-04-29,-53,HS
1819,Anderson Mill,458,484,2014-05-06,-26,ES
1820,Berkman,520,544,2014-05-06,-24,ES
1821,Blackland Prairie,877,859,2014-05-06,18,ES
1822,Bluebonnet,575,638,2014-05-06,-63,ES
1823,Brushy Creek,821,762,2014-05-06,59,ES
1824,C.D. Fulkes,776,801,2014-05-06,-25,MS
1825,Cactus Ranch,1053,988,2014-05-06,65,ES
1826,Caldwell Heights,630,598,2014-05-06,32,ES
1827,Callison,851,910,2014-05-06,-59,ES
1828,Canyon Creek,458,426,2014-05-06,32,ES
1829,Canyon Vista,1303,1307,2014-05-06,-4,MS
1830,Caraway,692,658,2014-05-06,34,ES
1831,Cedar Ridge,2716,2865,2014-05-06,-149,HS
1832,Cedar Valley,1276,1242,2014-05-06,34,MS
1833,Chandler Oaks,576,641,2014-05-06,-65,ES
1834,Chisholm Trail,1076,1067,2014-05-06,9,MS
1835,Deepwood,396,411,2014-05-06,-15,ES
1836,Deerpark,933,947,2014-05-06,-14,MS
1837,Double File Trail,701,701,2014-05-06,0,ES
1838,DAEP,8,2,2014-05-06,6,Other
1839,England,750,611,2014-05-06,139,ES
1840,Fern Bluff,726,734,2014-05-06,-8,ES
1841,Forest Creek,851,825,2014-05-06,26,ES
1842,Forest North,429,422,2014-05-06,7,ES
1843,Gattis,766,809,2014-05-06,-43,ES
1844,Great Oaks,753,735,2014-05-06,18,ES
1845,Grisham,693,672,2014-05-06,21,MS
1846,Hernandez,846,858,2014-05-06,-12,MS
1847,Herrington,792,774,2014-05-06,18,ES
1848,Hopewell,903,900,2014-05-06,3,MS
1849,JJAEP,41,25,2014-05-06,16,Other
1850,Jollyville,487,509,2014-05-06,-22,ES
1851,Laurel Mountain,800,780,2014-05-06,20,ES
1852,Live Oak,558,586,2014-05-06,-28,ES
1853,McNeil,2378,2463,2014-05-06,-85,HS
1854,Old Town,773,791,2014-05-06,-18,ES
1855,Pond Springs,644,651,2014-05-06,-7,ES
1856,Purple Sage,338,323,2014-05-06,15,ES
1857,Round Rock Opportunity Center,103,58,2014-05-06,45,Other
1858,Ridgeview,1358,1399,2014-05-06,-41,MS
1859,Robertson,523,534,2014-05-06,-11,ES
1860,Round Rock,2800,2893,2014-05-06,-93,HS
1861,Sommer,917,843,2014-05-06,74,ES
1862,Spicewood,763,734,2014-05-06,29,ES
1863,Stony Point,2284,2367,2014-05-06,-83,HS
1864,Success,160,109,2014-05-06,51,HS
1865,Teravista,826,798,2014-05-06,28,ES
1866,Union Hill,843,849,2014-05-06,-6,ES
1867,Voigt,610,586,2014-05-06,24,ES
1868,Walsh,1369,1352,2014-05-06,17,MS
1869,Wells Branch,1001,995,2014-05-06,6,ES
1870,Westwood,2573,2624,2014-05-06,-51,HS
1871,Anderson Mill,457,484,2014-05-13,-27,ES
1872,Berkman,520,544,2014-05-13,-24,ES
1873,Blackland Prairie,876,859,2014-05-13,17,ES
1874,Bluebonnet,575,638,2014-05-13,-63,ES
1875,Brushy Creek,819,762,2014-05-13,57,ES
1876,C.D. Fulkes,773,801,2014-05-13,-28,MS
1877,Cactus Ranch,1052,988,2014-05-13,64,ES
1878,Caldwell Heights,628,598,2014-05-13,30,ES
1879,Callison,850,910,2014-05-13,-60,ES
1880,Canyon Creek,458,426,2014-05-13,32,ES
1881,Canyon Vista,1301,1307,2014-05-13,-6,MS
1882,Caraway,694,658,2014-05-13,36,ES
1883,Cedar Ridge,2710,2865,2014-05-13,-155,HS
1884,Cedar Valley,1276,1242,2014-05-13,34,MS
1885,Chandler Oaks,576,641,2014-05-13,-65,ES
1886,Chisholm Trail,1075,1067,2014-05-13,8,MS
1887,Deepwood,394,411,2014-05-13,-17,ES
1888,Deerpark,931,947,2014-05-13,-16,MS
1889,Double File Trail,702,701,2014-05-13,1,ES
1890,DAEP,7,2,2014-05-13,5,Other
1891,England,753,611,2014-05-13,142,ES
1892,Fern Bluff,726,734,2014-05-13,-8,ES
1893,Forest Creek,851,825,2014-05-13,26,ES
1894,Forest North,432,422,2014-05-13,10,ES
1895,Gattis,767,809,2014-05-13,-42,ES
1896,Great Oaks,754,735,2014-05-13,19,ES
1897,Grisham,693,672,2014-05-13,21,MS
1898,Hernandez,844,858,2014-05-13,-14,MS
1899,Herrington,792,774,2014-05-13,18,ES
1900,Hopewell,903,900,2014-05-13,3,MS
1901,JJAEP,40,25,2014-05-13,15,Other
1902,Jollyville,487,509,2014-05-13,-22,ES
1903,Laurel Mountain,798,780,2014-05-13,18,ES
1904,Live Oak,559,586,2014-05-13,-27,ES
1905,McNeil,2379,2463,2014-05-13,-84,HS
1906,Old Town,773,791,2014-05-13,-18,ES
1907,Pond Springs,642,651,2014-05-13,-9,ES
1908,Purple Sage,338,323,2014-05-13,15,ES
1909,Round Rock Opportunity Center,119,58,2014-05-13,61,Other
1910,Ridgeview,1355,1399,2014-05-13,-44,MS
1911,Robertson,522,534,2014-05-13,-12,ES
1912,Round Rock,2800,2893,2014-05-13,-93,HS
1913,Sommer,918,843,2014-05-13,75,ES
1914,Spicewood,763,734,2014-05-13,29,ES
1915,Stony Point,2278,2367,2014-05-13,-89,HS
1916,Success,148,109,2014-05-13,39,HS
1917,Teravista,827,798,2014-05-13,29,ES
1918,Union Hill,843,849,2014-05-13,-6,ES
1919,Voigt,611,586,2014-05-13,25,ES
1920,Walsh,1370,1352,2014-05-13,18,MS
1921,Wells Branch,1000,995,2014-05-13,5,ES
1922,Westwood,2573,2624,2014-05-13,-51,HS
1923,Anderson Mill,456,484,2014-05-20,-28,ES
1924,Berkman,520,544,2014-05-20,-24,ES
1925,Blackland Prairie,877,859,2014-05-20,18,ES
1926,Bluebonnet,575,638,2014-05-20,-63,ES
1927,Brushy Creek,819,762,2014-05-20,57,ES
1928,C.D. Fulkes,772,801,2014-05-20,-29,MS
1929,Cactus Ranch,1050,988,2014-05-20,62,ES
1930,Caldwell Heights,628,598,2014-05-20,30,ES
1931,Callison,850,910,2014-05-20,-60,ES
1932,Canyon Creek,458,426,2014-05-20,32,ES
1933,Canyon Vista,1298,1307,2014-05-20,-9,MS
1934,Caraway,695,658,2014-05-20,37,ES
1935,Cedar Ridge,2697,2865,2014-05-20,-168,HS
1936,Cedar Valley,1275,1242,2014-05-20,33,MS
1937,Chandler Oaks,576,641,2014-05-20,-65,ES
1938,Chisholm Trail,1074,1067,2014-05-20,7,MS
1939,Deepwood,394,411,2014-05-20,-17,ES
1940,Deerpark,931,947,2014-05-20,-16,MS
1941,Double File Trail,702,701,2014-05-20,1,ES
1942,DAEP,8,2,2014-05-20,6,Other
1943,England,750,611,2014-05-20,139,ES
1944,Fern Bluff,727,734,2014-05-20,-7,ES
1945,Forest Creek,854,825,2014-05-20,29,ES
1946,Forest North,432,422,2014-05-20,10,ES
1947,Gattis,768,809,2014-05-20,-41,ES
1948,Great Oaks,753,735,2014-05-20,18,ES
1949,Grisham,693,672,2014-05-20,21,MS
1950,Hernandez,843,858,2014-05-20,-15,MS
1951,Herrington,792,774,2014-05-20,18,ES
1952,Hopewell,903,900,2014-05-20,3,MS
1953,JJAEP,42,25,2014-05-20,17,Other
1954,Jollyville,487,509,2014-05-20,-22,ES
1955,Laurel Mountain,797,780,2014-05-20,17,ES
1956,Live Oak,559,586,2014-05-20,-27,ES
1957,McNeil,2377,2463,2014-05-20,-86,HS
1958,Old Town,775,791,2014-05-20,-16,ES
1959,Pond Springs,641,651,2014-05-20,-10,ES
1960,Purple Sage,339,323,2014-05-20,16,ES
1961,Round Rock Opportunity Center,140,58,2014-05-20,82,Other
1962,Ridgeview,1356,1399,2014-05-20,-43,MS
1963,Robertson,522,534,2014-05-20,-12,ES
1964,Round Rock,2792,2893,2014-05-20,-101,HS
1965,Sommer,918,843,2014-05-20,75,ES
1966,Spicewood,761,734,2014-05-20,27,ES
1967,Stony Point,2275,2367,2014-05-20,-92,HS
1968,Success,126,109,2014-05-20,17,HS
1969,Teravista,827,798,2014-05-20,29,ES
1970,Union Hill,846,849,2014-05-20,-3,ES
1971,Voigt,612,586,2014-05-20,26,ES
1972,Walsh,1370,1352,2014-05-20,18,MS
1973,Wells Branch,1003,995,2014-05-20,8,ES
1974,Westwood,2575,2624,2014-05-20,-49,HS
1975,Anderson Mill,456,484,2014-05-27,-28,ES
1976,Berkman,520,544,2014-05-27,-24,ES
1977,Blackland Prairie,877,859,2014-05-27,18,ES
1978,Bluebonnet,571,638,2014-05-27,-67,ES
1979,Brushy Creek,820,762,2014-05-27,58,ES
1980,C.D. Fulkes,771,801,2014-05-27,-30,MS
1981,Cactus Ranch,1050,988,2014-05-27,62,ES
1982,Caldwell Heights,628,598,2014-05-27,30,ES
1983,Callison,848,910,2014-05-27,-62,ES
1984,Canyon Creek,458,426,2014-05-27,32,ES
1985,Canyon Vista,1298,1307,2014-05-27,-9,MS
1986,Caraway,695,658,2014-05-27,37,ES
1987,Cedar Ridge,2699,2865,2014-05-27,-166,HS
1988,Cedar Valley,1275,1242,2014-05-27,33,MS
1989,Chandler Oaks,575,641,2014-05-27,-66,ES
1990,Chisholm Trail,1075,1067,2014-05-27,8,MS
1991,Deepwood,394,411,2014-05-27,-17,ES
1992,Deerpark,929,947,2014-05-27,-18,MS
1993,Double File Trail,701,701,2014-05-27,0,ES
1994,DAEP,8,2,2014-05-27,6,Other
1995,England,749,611,2014-05-27,138,ES
1996,Fern Bluff,727,734,2014-05-27,-7,ES
1997,Forest Creek,854,825,2014-05-27,29,ES
1998,Forest North,428,422,2014-05-27,6,ES
1999,Gattis,768,809,2014-05-27,-41,ES
2000,Great Oaks,752,735,2014-05-27,17,ES
2001,Grisham,693,672,2014-05-27,21,MS
2002,Hernandez,843,858,2014-05-27,-15,MS
2003,Herrington,791,774,2014-05-27,17,ES
2004,Hopewell,903,900,2014-05-27,3,MS
2005,JJAEP,40,25,2014-05-27,15,Other
2006,Jollyville,486,509,2014-05-27,-23,ES
2007,Laurel Mountain,798,780,2014-05-27,18,ES
2008,Live Oak,558,586,2014-05-27,-28,ES
2009,McNeil,2377,2463,2014-05-27,-86,HS
2010,Old Town,775,791,2014-05-27,-16,ES
2011,Pond Springs,641,651,2014-05-27,-10,ES
2012,Purple Sage,339,323,2014-05-27,16,ES
2013,Round Rock Opportunity Center,143,58,2014-05-27,85,Other
2014,Ridgeview,1357,1399,2014-05-27,-42,MS
2015,Robertson,522,534,2014-05-27,-12,ES
2016,Round Rock,2792,2893,2014-05-27,-101,HS
2017,Sommer,915,843,2014-05-27,72,ES
2018,Spicewood,761,734,2014-05-27,27,ES
2019,Stony Point,2275,2367,2014-05-27,-92,HS
2020,Success,106,109,2014-05-27,-3,HS
2021,Teravista,824,798,2014-05-27,26,ES
2022,Union Hill,845,849,2014-05-27,-4,ES
2023,Voigt,611,586,2014-05-27,25,ES
2024,Walsh,1370,1352,2014-05-27,18,MS
2025,Wells Branch,1002,995,2014-05-27,7,ES
2026,Westwood,2574,2624,2014-05-27,-50,HS
2027,Anderson Mill,474,492,2014-08-26,-18,ES
2028,Berkman,476,548,2014-08-26,-72,ES
2029,Blackland Prairie,843,831,2014-08-26,12,ES
2030,Bluebonnet,578,591,2014-08-26,-13,ES
2031,Brushy Creek,792,778,2014-08-26,14,ES
2032,C.D. Fulkes,778,778,2014-08-26,0,MS
2033,Cactus Ranch,1048,1071,2014-08-26,-23,ES
2034,Caldwell Heights,659,657,2014-08-26,2,ES
2035,Callison,869,910,2014-08-26,-41,ES
2036,Canyon Creek,428,462,2014-08-26,-34,ES
2037,Canyon Vista,1386,1344,2014-08-26,42,MS
2038,Caraway,709,701,2014-08-26,8,ES
2039,Cedar Ridge,2728,2732,2014-08-26,-4,HS
2040,Cedar Valley,1342,1305,2014-08-26,37,MS
2041,Chandler Oaks,531,570,2014-08-26,-39,ES
2042,Chisholm Trail,1081,1019,2014-08-26,62,MS
2043,Deepwood,386,389,2014-08-26,-3,ES
2044,Deerpark,976,983,2014-08-26,-7,MS
2045,Double File Trail,681,753,2014-08-26,-72,ES
2046,DAEP,0,7,2014-08-26,-7,Other
2047,England,787,805,2014-08-26,-18,ES
2048,Fern Bluff,663,719,2014-08-26,-56,ES
2049,Forest Creek,834,860,2014-08-26,-26,ES
2050,Forest North,399,444,2014-08-26,-45,ES
2051,Gattis,783,782,2014-08-26,1,ES
2052,Great Oaks,710,694,2014-08-26,16,ES
2053,Grisham,645,648,2014-08-26,-3,MS
2054,Hernandez,844,848,2014-08-26,-4,MS
2055,Herrington,830,809,2014-08-26,21,ES
2056,Hopewell,983,899,2014-08-26,84,MS
2057,JJAEP,19,26,2014-08-26,-7,Other
2058,Jollyville,452,444,2014-08-26,8,ES
2059,Laurel Mountain,746,767,2014-08-26,-21,ES
2060,Live Oak,522,570,2014-08-26,-48,ES
2061,McNeil,2593,2556,2014-08-26,37,HS
2062,Old Town,736,749,2014-08-26,-13,ES
2063,Pond Springs,637,641,2014-08-26,-4,ES
2064,Purple Sage,315,343,2014-08-26,-28,ES
2065,Round Rock Opportunity Center,42,46,2014-08-26,-4,Other
2066,Ridgeview,1359,1359,2014-08-26,0,MS
2067,Robertson,481,503,2014-08-26,-22,ES
2068,Round Rock,3020,2995,2014-08-26,25,HS
2069,Sommer,969,969,2014-08-26,0,ES
2070,Spicewood,783,785,2014-08-26,-2,ES
2071,Stony Point,2541,2492,2014-08-26,49,HS
2072,Success,346,128,2014-08-26,218,HS
2073,Teravista,855,883,2014-08-26,-28,ES
2074,Union Hill,856,877,2014-08-26,-21,ES
2075,Voigt,566,604,2014-08-26,-38,ES
2076,Walsh,1455,1455,2014-08-26,0,MS
2077,Wells Branch,944,1075,2014-08-26,-131,ES
2078,Westwood,2748,2721,2014-08-26,27,HS
2079,Anderson Mill,460,492,2014-09-02,-32,ES
2080,Berkman,491,548,2014-09-02,-57,ES
2081,Blackland Prairie,844,831,2014-09-02,13,ES
2082,Bluebonnet,586,591,2014-09-02,-5,ES
2083,Brushy Creek,778,778,2014-09-02,0,ES
2084,C.D. Fulkes,749,778,2014-09-02,-29,MS
2085,Cactus Ranch,1055,1071,2014-09-02,-16,ES
2086,Caldwell Heights,637,657,2014-09-02,-20,ES
2087,Callison,841,910,2014-09-02,-69,ES
2088,Canyon Creek,434,462,2014-09-02,-28,ES
2089,Canyon Vista,1368,1344,2014-09-02,24,MS
2090,Caraway,694,701,2014-09-02,-7,ES
2091,Cedar Ridge,2703,2732,2014-09-02,-29,HS
2092,Cedar Valley,1317,1305,2014-09-02,12,MS
2093,Chandler Oaks,535,570,2014-09-02,-35,ES
2094,Chisholm Trail,1064,1019,2014-09-02,45,MS
2095,Deepwood,393,389,2014-09-02,4,ES
2096,Deerpark,944,983,2014-09-02,-39,MS
2097,Double File Trail,666,753,2014-09-02,-87,ES
2098,DAEP,0,7,2014-09-02,-7,Other
2099,England,779,805,2014-09-02,-26,ES
2100,Fern Bluff,668,719,2014-09-02,-51,ES
2101,Forest Creek,837,860,2014-09-02,-23,ES
2102,Forest North,404,444,2014-09-02,-40,ES
2103,Gattis,784,782,2014-09-02,2,ES
2104,Great Oaks,719,694,2014-09-02,25,ES
2105,Grisham,657,648,2014-09-02,9,MS
2106,Hernandez,818,848,2014-09-02,-30,MS
2107,Herrington,841,809,2014-09-02,32,ES
2108,Hopewell,964,899,2014-09-02,65,MS
2109,JJAEP,20,26,2014-09-02,-6,Other
2110,Jollyville,443,444,2014-09-02,-1,ES
2111,Laurel Mountain,761,767,2014-09-02,-6,ES
2112,Live Oak,535,570,2014-09-02,-35,ES
2113,McNeil,2555,2556,2014-09-02,-1,HS
2114,Old Town,740,749,2014-09-02,-9,ES
2115,Pond Springs,647,641,2014-09-02,6,ES
2116,Purple Sage,315,343,2014-09-02,-28,ES
2117,Round Rock Opportunity Center,41,46,2014-09-02,-5,Other
2118,Ridgeview,1367,1359,2014-09-02,8,MS
2119,Robertson,497,503,2014-09-02,-6,ES
2120,Round Rock,2989,2995,2014-09-02,-6,HS
2121,Sommer,980,969,2014-09-02,11,ES
2122,Spicewood,792,785,2014-09-02,7,ES
2123,Stony Point,2489,2492,2014-09-02,-3,HS
2124,Success,317,128,2014-09-02,189,HS
2125,Teravista,869,883,2014-09-02,-14,ES
2126,Union Hill,841,877,2014-09-02,-36,ES
2127,Voigt,568,604,2014-09-02,-36,ES
2128,Walsh,1465,1455,2014-09-02,10,MS
2129,Wells Branch,953,1075,2014-09-02,-122,ES
2130,Westwood,2718,2721,2014-09-02,-3,HS
2131,Anderson Mill,466,492,2014-09-09,-26,ES
2132,Berkman,495,548,2014-09-09,-53,ES
2133,Blackland Prairie,845,831,2014-09-09,14,ES
2134,Bluebonnet,587,591,2014-09-09,-4,ES
2135,Brushy Creek,781,778,2014-09-09,3,ES
2136,C.D. Fulkes,750,778,2014-09-09,-28,MS
2137,Cactus Ranch,1056,1071,2014-09-09,-15,ES
2138,Caldwell Heights,640,657,2014-09-09,-17,ES
2139,Callison,847,910,2014-09-09,-63,ES
2140,Canyon Creek,434,462,2014-09-09,-28,ES
2141,Canyon Vista,1374,1344,2014-09-09,30,MS
2142,Caraway,704,701,2014-09-09,3,ES
2143,Cedar Ridge,2712,2732,2014-09-09,-20,HS
2144,Cedar Valley,1319,1305,2014-09-09,14,MS
2145,Chandler Oaks,535,570,2014-09-09,-35,ES
2146,Chisholm Trail,1067,1019,2014-09-09,48,MS
2147,Deepwood,393,389,2014-09-09,4,ES
2148,Deerpark,942,983,2014-09-09,-41,MS
2149,Double File Trail,669,753,2014-09-09,-84,ES
2150,DAEP,0,7,2014-09-09,-7,Other
2151,England,787,805,2014-09-09,-18,ES
2152,Fern Bluff,669,719,2014-09-09,-50,ES
2153,Forest Creek,836,860,2014-09-09,-24,ES
2154,Forest North,408,444,2014-09-09,-36,ES
2155,Gattis,787,782,2014-09-09,5,ES
2156,Great Oaks,718,694,2014-09-09,24,ES
2157,Grisham,658,648,2014-09-09,10,MS
2158,Hernandez,821,848,2014-09-09,-27,MS
2159,Herrington,843,809,2014-09-09,34,ES
2160,Hopewell,967,899,2014-09-09,68,MS
2161,JJAEP,22,26,2014-09-09,-4,Other
2162,Jollyville,445,444,2014-09-09,1,ES
2163,Laurel Mountain,763,767,2014-09-09,-4,ES
2164,Live Oak,538,570,2014-09-09,-32,ES
2165,McNeil,2549,2556,2014-09-09,-7,HS
2166,Old Town,738,749,2014-09-09,-11,ES
2167,Pond Springs,646,641,2014-09-09,5,ES
2168,Purple Sage,315,343,2014-09-09,-28,ES
2169,Round Rock Opportunity Center,45,46,2014-09-09,-1,Other
2170,Ridgeview,1370,1359,2014-09-09,11,MS
2171,Robertson,500,503,2014-09-09,-3,ES
2172,Round Rock,2996,2995,2014-09-09,1,HS
2173,Sommer,978,969,2014-09-09,9,ES
2174,Spicewood,793,785,2014-09-09,8,ES
2175,Stony Point,2494,2492,2014-09-09,2,HS
2176,Success,317,128,2014-09-09,189,HS
2177,Teravista,872,883,2014-09-09,-11,ES
2178,Union Hill,846,877,2014-09-09,-31,ES
2179,Voigt,576,604,2014-09-09,-28,ES
2180,Walsh,1461,1455,2014-09-09,6,MS
2181,Wells Branch,951,1075,2014-09-09,-124,ES
2182,Westwood,2726,2721,2014-09-09,5,HS
2183,Anderson Mill,468,492,2014-09-16,-24,ES
2184,Berkman,500,548,2014-09-16,-48,ES
2185,Blackland Prairie,844,831,2014-09-16,13,ES
2186,Bluebonnet,588,591,2014-09-16,-3,ES
2187,Brushy Creek,782,778,2014-09-16,4,ES
2188,C.D. Fulkes,753,778,2014-09-16,-25,MS
2189,Cactus Ranch,1054,1071,2014-09-16,-17,ES
2190,Caldwell Heights,643,657,2014-09-16,-14,ES
2191,Callison,846,910,2014-09-16,-64,ES
2192,Canyon Creek,435,462,2014-09-16,-27,ES
2193,Canyon Vista,1375,1344,2014-09-16,31,MS
2194,Caraway,706,701,2014-09-16,5,ES
2195,Cedar Ridge,2708,2732,2014-09-16,-24,HS
2196,Cedar Valley,1320,1305,2014-09-16,15,MS
2197,Chandler Oaks,538,570,2014-09-16,-32,ES
2198,Chisholm Trail,1066,1019,2014-09-16,47,MS
2199,Deepwood,393,389,2014-09-16,4,ES
2200,Deerpark,942,983,2014-09-16,-41,MS
2201,Double File Trail,663,753,2014-09-16,-90,ES
2202,DAEP,1,7,2014-09-16,-6,Other
2203,England,789,805,2014-09-16,-16,ES
2204,Fern Bluff,669,719,2014-09-16,-50,ES
2205,Forest Creek,834,860,2014-09-16,-26,ES
2206,Forest North,411,444,2014-09-16,-33,ES
2207,Gattis,791,782,2014-09-16,9,ES
2208,Great Oaks,717,694,2014-09-16,23,ES
2209,Grisham,659,648,2014-09-16,11,MS
2210,Hernandez,824,848,2014-09-16,-24,MS
2211,Herrington,842,809,2014-09-16,33,ES
2212,Hopewell,970,899,2014-09-16,71,MS
2213,JJAEP,22,26,2014-09-16,-4,Other
2214,Jollyville,448,444,2014-09-16,4,ES
2215,Laurel Mountain,766,767,2014-09-16,-1,ES
2216,Live Oak,534,570,2014-09-16,-36,ES
2217,McNeil,2549,2556,2014-09-16,-7,HS
2218,Old Town,740,749,2014-09-16,-9,ES
2219,Pond Springs,647,641,2014-09-16,6,ES
2220,Purple Sage,315,343,2014-09-16,-28,ES
2221,Round Rock Opportunity Center,44,46,2014-09-16,-2,Other
2222,Ridgeview,1373,1359,2014-09-16,14,MS
2223,Robertson,504,503,2014-09-16,1,ES
2224,Round Rock,3001,2995,2014-09-16,6,HS
2225,Sommer,983,969,2014-09-16,14,ES
2226,Spicewood,794,785,2014-09-16,9,ES
2227,Stony Point,2495,2492,2014-09-16,3,HS
2228,Success,321,128,2014-09-16,193,HS
2229,Teravista,871,883,2014-09-16,-12,ES
2230,Union Hill,841,877,2014-09-16,-36,ES
2231,Voigt,573,604,2014-09-16,-31,ES
2232,Walsh,1461,1455,2014-09-16,6,MS
2233,Wells Branch,953,1075,2014-09-16,-122,ES
2234,Westwood,2722,2721,2014-09-16,1,HS
2235,Anderson Mill,470,492,2014-09-23,-22,ES
2236,Berkman,506,548,2014-09-23,-42,ES
2237,Blackland Prairie,845,831,2014-09-23,14,ES
2238,Bluebonnet,590,591,2014-09-23,-1,ES
2239,Brushy Creek,779,778,2014-09-23,1,ES
2240,C.D. Fulkes,753,778,2014-09-23,-25,MS
2241,Cactus Ranch,1059,1071,2014-09-23,-12,ES
2242,Caldwell Heights,646,657,2014-09-23,-11,ES
2243,Callison,851,910,2014-09-23,-59,ES
2244,Canyon Creek,433,462,2014-09-23,-29,ES
2245,Canyon Vista,1372,1344,2014-09-23,28,MS
2246,Caraway,706,701,2014-09-23,5,ES
2247,Cedar Ridge,2707,2732,2014-09-23,-25,HS
2248,Cedar Valley,1319,1305,2014-09-23,14,MS
2249,Chandler Oaks,538,570,2014-09-23,-32,ES
2250,Chisholm Trail,1065,1019,2014-09-23,46,MS
2251,Deepwood,394,389,2014-09-23,5,ES
2252,Deerpark,939,983,2014-09-23,-44,MS
2253,Double File Trail,662,753,2014-09-23,-91,ES
2254,DAEP,2,7,2014-09-23,-5,Other
2255,England,788,805,2014-09-23,-17,ES
2256,Fern Bluff,670,719,2014-09-23,-49,ES
2257,Forest Creek,833,860,2014-09-23,-27,ES
2258,Forest North,412,444,2014-09-23,-32,ES
2259,Gattis,790,782,2014-09-23,8,ES
2260,Great Oaks,714,694,2014-09-23,20,ES
2261,Grisham,659,648,2014-09-23,11,MS
2262,Hernandez,826,848,2014-09-23,-22,MS
2263,Herrington,844,809,2014-09-23,35,ES
2264,Hopewell,970,899,2014-09-23,71,MS
2265,JJAEP,22,26,2014-09-23,-4,Other
2266,Jollyville,453,444,2014-09-23,9,ES
2267,Laurel Mountain,768,767,2014-09-23,1,ES
2268,Live Oak,533,570,2014-09-23,-37,ES
2269,McNeil,2544,2556,2014-09-23,-12,HS
2270,Old Town,739,749,2014-09-23,-10,ES
2271,Pond Springs,644,641,2014-09-23,3,ES
2272,Purple Sage,317,343,2014-09-23,-26,ES
2273,Round Rock Opportunity Center,53,46,2014-09-23,7,Other
2274,Ridgeview,1374,1359,2014-09-23,15,MS
2275,Robertson,501,503,2014-09-23,-2,ES
2276,Round Rock,2991,2995,2014-09-23,-4,HS
2277,Sommer,983,969,2014-09-23,14,ES
2278,Spicewood,793,785,2014-09-23,8,ES
2279,Stony Point,2489,2492,2014-09-23,-3,HS
2280,Success,327,128,2014-09-23,199,HS
2281,Teravista,873,883,2014-09-23,-10,ES
2282,Union Hill,841,877,2014-09-23,-36,ES
2283,Voigt,573,604,2014-09-23,-31,ES
2284,Walsh,1458,1455,2014-09-23,3,MS
2285,Wells Branch,949,1075,2014-09-23,-126,ES
2286,Westwood,2726,2721,2014-09-23,5,HS
2287,Anderson Mill,470,492,2014-09-30,-22,ES
2288,Berkman,509,548,2014-09-30,-39,ES
2289,Blackland Prairie,845,831,2014-09-30,14,ES
2290,Bluebonnet,596,591,2014-09-30,5,ES
2291,Brushy Creek,786,778,2014-09-30,8,ES
2292,C.D. Fulkes,755,778,2014-09-30,-23,MS
2293,Cactus Ranch,1062,1071,2014-09-30,-9,ES
2294,Caldwell Heights,646,657,2014-09-30,-11,ES
2295,Callison,856,910,2014-09-30,-54,ES
2296,Canyon Creek,434,462,2014-09-30,-28,ES
2297,Canyon Vista,1371,1344,2014-09-30,27,MS
2298,Caraway,704,701,2014-09-30,3,ES
2299,Cedar Ridge,2708,2732,2014-09-30,-24,HS
2300,Cedar Valley,1317,1305,2014-09-30,12,MS
2301,Chandler Oaks,541,570,2014-09-30,-29,ES
2302,Chisholm Trail,1068,1019,2014-09-30,49,MS
2303,Deepwood,399,389,2014-09-30,10,ES
2304,Deerpark,939,983,2014-09-30,-44,MS
2305,Double File Trail,660,753,2014-09-30,-93,ES
2306,DAEP,2,7,2014-09-30,-5,Other
2307,England,790,805,2014-09-30,-15,ES
2308,Fern Bluff,670,719,2014-09-30,-49,ES
2309,Forest Creek,832,860,2014-09-30,-28,ES
2310,Forest North,410,444,2014-09-30,-34,ES
2311,Gattis,788,782,2014-09-30,6,ES
2312,Great Oaks,716,694,2014-09-30,22,ES
2313,Grisham,662,648,2014-09-30,14,MS
2314,Hernandez,823,848,2014-09-30,-25,MS
2315,Herrington,842,809,2014-09-30,33,ES
2316,Hopewell,973,899,2014-09-30,74,MS
2317,JJAEP,20,26,2014-09-30,-6,Other
2318,Jollyville,451,444,2014-09-30,7,ES
2319,Laurel Mountain,769,767,2014-09-30,2,ES
2320,Live Oak,534,570,2014-09-30,-36,ES
2321,McNeil,2551,2556,2014-09-30,-5,HS
2322,Old Town,738,749,2014-09-30,-11,ES
2323,Pond Springs,647,641,2014-09-30,6,ES
2324,Purple Sage,318,343,2014-09-30,-25,ES
2325,Round Rock Opportunity Center,56,46,2014-09-30,10,Other
2326,Ridgeview,1375,1359,2014-09-30,16,MS
2327,Robertson,502,503,2014-09-30,-1,ES
2328,Round Rock,2990,2995,2014-09-30,-5,HS
2329,Sommer,981,969,2014-09-30,12,ES
2330,Spicewood,794,785,2014-09-30,9,ES
2331,Stony Point,2486,2492,2014-09-30,-6,HS
2332,Success,326,128,2014-09-30,198,HS
2333,Teravista,872,883,2014-09-30,-11,ES
2334,Union Hill,838,877,2014-09-30,-39,ES
2335,Voigt,575,604,2014-09-30,-29,ES
2336,Walsh,1457,1455,2014-09-30,2,MS
2337,Wells Branch,945,1075,2014-09-30,-130,ES
2338,Westwood,2729,2721,2014-09-30,8,HS
2339,Anderson Mill,471,492,2014-10-08,-21,ES
2340,Berkman,510,548,2014-10-08,-38,ES
2341,Blackland Prairie,846,831,2014-10-08,15,ES
2342,Bluebonnet,596,591,2014-10-08,5,ES
2343,Brushy Creek,785,778,2014-10-08,7,ES
2344,C.D. Fulkes,756,778,2014-10-08,-22,MS
2345,Cactus Ranch,1062,1071,2014-10-08,-9,ES
2346,Caldwell Heights,647,657,2014-10-08,-10,ES
2347,Callison,852,910,2014-10-08,-58,ES
2348,Canyon Creek,434,462,2014-10-08,-28,ES
2349,Canyon Vista,1373,1344,2014-10-08,29,MS
2350,Caraway,708,701,2014-10-08,7,ES
2351,Cedar Ridge,2719,2732,2014-10-08,-13,HS
2352,Cedar Valley,1317,1305,2014-10-08,12,MS
2353,Chandler Oaks,541,570,2014-10-08,-29,ES
2354,Chisholm Trail,1069,1019,2014-10-08,50,MS
2355,Deepwood,399,389,2014-10-08,10,ES
2356,Deerpark,937,983,2014-10-08,-46,MS
2357,Double File Trail,653,753,2014-10-08,-100,ES
2358,DAEP,4,7,2014-10-08,-3,Other
2359,England,791,805,2014-10-08,-14,ES
2360,Fern Bluff,671,719,2014-10-08,-48,ES
2361,Forest Creek,836,860,2014-10-08,-24,ES
2362,Forest North,410,444,2014-10-08,-34,ES
2363,Gattis,788,782,2014-10-08,6,ES
2364,Great Oaks,717,694,2014-10-08,23,ES
2365,Grisham,663,648,2014-10-08,15,MS
2366,Hernandez,823,848,2014-10-08,-25,MS
2367,Herrington,843,809,2014-10-08,34,ES
2368,Hopewell,970,899,2014-10-08,71,MS
2369,JJAEP,20,26,2014-10-08,-6,Other
2370,Jollyville,449,444,2014-10-08,5,ES
2371,Laurel Mountain,769,767,2014-10-08,2,ES
2372,Live Oak,533,570,2014-10-08,-37,ES
2373,McNeil,2547,2556,2014-10-08,-9,HS
2374,Old Town,738,749,2014-10-08,-11,ES
2375,Pond Springs,648,641,2014-10-08,7,ES
2376,Purple Sage,318,343,2014-10-08,-25,ES
2377,Round Rock Opportunity Center,51,46,2014-10-08,5,Other
2378,Ridgeview,1375,1359,2014-10-08,16,MS
2379,Robertson,500,503,2014-10-08,-3,ES
2380,Round Rock,2989,2995,2014-10-08,-6,HS
2381,Sommer,984,969,2014-10-08,15,ES
2382,Spicewood,794,785,2014-10-08,9,ES
2383,Stony Point,2472,2492,2014-10-08,-20,HS
2384,Success,322,128,2014-10-08,194,HS
2385,Teravista,871,883,2014-10-08,-12,ES
2386,Union Hill,838,877,2014-10-08,-39,ES
2387,Voigt,576,604,2014-10-08,-28,ES
2388,Walsh,1457,1455,2014-10-08,2,MS
2389,Wells Branch,942,1075,2014-10-08,-133,ES
2390,Westwood,2731,2721,2014-10-08,10,HS
2391,Anderson Mill,468,492,2014-10-15,-24,ES
2392,Berkman,508,548,2014-10-15,-40,ES
2393,Blackland Prairie,846,831,2014-10-15,15,ES
2394,Bluebonnet,594,591,2014-10-15,3,ES
2395,Brushy Creek,779,778,2014-10-15,1,ES
2396,C.D. Fulkes,757,778,2014-10-15,-21,MS
2397,Cactus Ranch,1064,1071,2014-10-15,-7,ES
2398,Caldwell Heights,646,657,2014-10-15,-11,ES
2399,Callison,859,910,2014-10-15,-51,ES
2400,Canyon Creek,434,462,2014-10-15,-28,ES
2401,Canyon Vista,1375,1344,2014-10-15,31,MS
2402,Caraway,709,701,2014-10-15,8,ES
2403,Cedar Ridge,2723,2732,2014-10-15,-9,HS
2404,Cedar Valley,1315,1305,2014-10-15,10,MS
2405,Chandler Oaks,544,570,2014-10-15,-26,ES
2406,Chisholm Trail,1068,1019,2014-10-15,49,MS
2407,Deepwood,399,389,2014-10-15,10,ES
2408,Deerpark,936,983,2014-10-15,-47,MS
2409,Double File Trail,652,753,2014-10-15,-101,ES
2410,DAEP,7,7,2014-10-15,0,Other
2411,England,793,805,2014-10-15,-12,ES
2412,Fern Bluff,671,719,2014-10-15,-48,ES
2413,Forest Creek,836,860,2014-10-15,-24,ES
2414,Forest North,411,444,2014-10-15,-33,ES
2415,Gattis,789,782,2014-10-15,7,ES
2416,Great Oaks,714,694,2014-10-15,20,ES
2417,Grisham,663,648,2014-10-15,15,MS
2418,Hernandez,831,848,2014-10-15,-17,MS
2419,Herrington,842,809,2014-10-15,33,ES
2420,Hopewell,969,899,2014-10-15,70,MS
2421,JJAEP,21,26,2014-10-15,-5,Other
2422,Jollyville,450,444,2014-10-15,6,ES
2423,Laurel Mountain,772,767,2014-10-15,5,ES
2424,Live Oak,532,570,2014-10-15,-38,ES
2425,McNeil,2550,2556,2014-10-15,-6,HS
2426,Old Town,738,749,2014-10-15,-11,ES
2427,Pond Springs,650,641,2014-10-15,9,ES
2428,Purple Sage,318,343,2014-10-15,-25,ES
2429,Round Rock Opportunity Center,44,46,2014-10-15,-2,Other
2430,Ridgeview,1374,1359,2014-10-15,15,MS
2431,Robertson,502,503,2014-10-15,-1,ES
2432,Round Rock,2986,2995,2014-10-15,-9,HS
2433,Sommer,985,969,2014-10-15,16,ES
2434,Spicewood,794,785,2014-10-15,9,ES
2435,Stony Point,2466,2492,2014-10-15,-26,HS
2436,Success,316,128,2014-10-15,188,HS
2437,Teravista,869,883,2014-10-15,-14,ES
2438,Union Hill,842,877,2014-10-15,-35,ES
2439,Voigt,576,604,2014-10-15,-28,ES
2440,Walsh,1457,1455,2014-10-15,2,MS
2441,Wells Branch,940,1075,2014-10-15,-135,ES
2442,Westwood,2731,2721,2014-10-15,10,HS
2443,Anderson Mill,472,492,2014-10-22,-20,ES
2444,Berkman,498,548,2014-10-22,-50,ES
2445,Blackland Prairie,847,831,2014-10-22,16,ES
2446,Bluebonnet,581,591,2014-10-22,-10,ES
2447,Brushy Creek,781,778,2014-10-22,3,ES
2448,C.D. Fulkes,756,778,2014-10-22,-22,MS
2449,Cactus Ranch,1064,1071,2014-10-22,-7,ES
2450,Caldwell Heights,649,657,2014-10-22,-8,ES
2451,Callison,858,910,2014-10-22,-52,ES
2452,Canyon Creek,435,462,2014-10-22,-27,ES
2453,Canyon Vista,1377,1344,2014-10-22,33,MS
2454,Caraway,711,701,2014-10-22,10,ES
2455,Cedar Ridge,2722,2732,2014-10-22,-10,HS
2456,Cedar Valley,1316,1305,2014-10-22,11,MS
2457,Chandler Oaks,544,570,2014-10-22,-26,ES
2458,Chisholm Trail,1068,1019,2014-10-22,49,MS
2459,Deepwood,398,389,2014-10-22,9,ES
2460,Deerpark,933,983,2014-10-22,-50,MS
2461,Double File Trail,652,753,2014-10-22,-101,ES
2462,DAEP,6,7,2014-10-22,-1,Other
2463,England,798,805,2014-10-22,-7,ES
2464,Fern Bluff,672,719,2014-10-22,-47,ES
2465,Forest Creek,835,860,2014-10-22,-25,ES
2466,Forest North,406,444,2014-10-22,-38,ES
2467,Gattis,789,782,2014-10-22,7,ES
2468,Great Oaks,715,694,2014-10-22,21,ES
2469,Grisham,664,648,2014-10-22,16,MS
2470,Hernandez,832,848,2014-10-22,-16,MS
2471,Herrington,842,809,2014-10-22,33,ES
2472,Hopewell,967,899,2014-10-22,68,MS
2473,JJAEP,22,26,2014-10-22,-4,Other
2474,Jollyville,458,444,2014-10-22,14,ES
2475,Laurel Mountain,772,767,2014-10-22,5,ES
2476,Live Oak,532,570,2014-10-22,-38,ES
2477,McNeil,2553,2556,2014-10-22,-3,HS
2478,Old Town,734,749,2014-10-22,-15,ES
2479,Pond Springs,654,641,2014-10-22,13,ES
2480,Purple Sage,318,343,2014-10-22,-25,ES
2481,Round Rock Opportunity Center,54,46,2014-10-22,8,Other
2482,Ridgeview,1374,1359,2014-10-22,15,MS
2483,Robertson,502,503,2014-10-22,-1,ES
2484,Round Rock,2978,2995,2014-10-22,-17,HS
2485,Sommer,984,969,2014-10-22,15,ES
2486,Spicewood,795,785,2014-10-22,10,ES
2487,Stony Point,2461,2492,2014-10-22,-31,HS
2488,Success,304,128,2014-10-22,176,HS
2489,Teravista,870,883,2014-10-22,-13,ES
2490,Union Hill,845,877,2014-10-22,-32,ES
2491,Voigt,577,604,2014-10-22,-27,ES
2492,Walsh,1459,1455,2014-10-22,4,MS
2493,Wells Branch,940,1075,2014-10-22,-135,ES
2494,Westwood,2729,2721,2014-10-22,8,HS
2495,Anderson Mill,473,492,2014-10-28,-19,ES
2496,Berkman,497,548,2014-10-28,-51,ES
2497,Blackland Prairie,849,831,2014-10-28,18,ES
2498,Bluebonnet,583,591,2014-10-28,-8,ES
2499,Brushy Creek,783,778,2014-10-28,5,ES
2500,C.D. Fulkes,755,778,2014-10-28,-23,MS
2501,Cactus Ranch,1066,1071,2014-10-28,-5,ES
2502,Caldwell Heights,644,657,2014-10-28,-13,ES
2503,Callison,855,910,2014-10-28,-55,ES
2504,Canyon Creek,436,462,2014-10-28,-26,ES
2505,Canyon Vista,1381,1344,2014-10-28,37,MS
2506,Caraway,708,701,2014-10-28,7,ES
2507,Cedar Ridge,2721,2732,2014-10-28,-11,HS
2508,Cedar Valley,1316,1305,2014-10-28,11,MS
2509,Chandler Oaks,544,570,2014-10-28,-26,ES
2510,Chisholm Trail,1069,1019,2014-10-28,50,MS
2511,Deepwood,400,389,2014-10-28,11,ES
2512,Deerpark,933,983,2014-10-28,-50,MS
2513,Double File Trail,653,753,2014-10-28,-100,ES
2514,DAEP,5,7,2014-10-28,-2,Other
2515,England,800,805,2014-10-28,-5,ES
2516,Fern Bluff,677,719,2014-10-28,-42,ES
2517,Forest Creek,834,860,2014-10-28,-26,ES
2518,Forest North,410,444,2014-10-28,-34,ES
2519,Gattis,791,782,2014-10-28,9,ES
2520,Great Oaks,717,694,2014-10-28,23,ES
2521,Grisham,660,648,2014-10-28,12,MS
2522,Hernandez,831,848,2014-10-28,-17,MS
2523,Herrington,841,809,2014-10-28,32,ES
2524,Hopewell,967,899,2014-10-28,68,MS
2525,JJAEP,24,26,2014-10-28,-2,Other
2526,Jollyville,462,444,2014-10-28,18,ES
2527,Laurel Mountain,777,767,2014-10-28,10,ES
2528,Live Oak,534,570,2014-10-28,-36,ES
2529,McNeil,2546,2556,2014-10-28,-10,HS
2530,Old Town,734,749,2014-10-28,-15,ES
2531,Pond Springs,651,641,2014-10-28,10,ES
2532,Purple Sage,319,343,2014-10-28,-24,ES
2533,Round Rock Opportunity Center,53,46,2014-10-28,7,Other
2534,Ridgeview,1374,1359,2014-10-28,15,MS
2535,Robertson,505,503,2014-10-28,2,ES
2536,Round Rock,2971,2995,2014-10-28,-24,HS
2537,Sommer,984,969,2014-10-28,15,ES
2538,Spicewood,795,785,2014-10-28,10,ES
2539,Stony Point,2463,2492,2014-10-28,-29,HS
2540,Success,309,128,2014-10-28,181,HS
2541,Teravista,875,883,2014-10-28,-8,ES
2542,Union Hill,846,877,2014-10-28,-31,ES
2543,Voigt,575,604,2014-10-28,-29,ES
2544,Walsh,1460,1455,2014-10-28,5,MS
2545,Wells Branch,940,1075,2014-10-28,-135,ES
2546,Westwood,2728,2721,2014-10-28,7,HS
2547,Anderson Mill,475,492,2014-11-04,-17,ES
2548,Berkman,495,548,2014-11-04,-53,ES
2549,Blackland Prairie,852,831,2014-11-04,21,ES
2550,Bluebonnet,578,591,2014-11-04,-13,ES
2551,Brushy Creek,783,778,2014-11-04,5,ES
2552,C.D. Fulkes,755,778,2014-11-04,-23,MS
2553,Cactus Ranch,1064,1071,2014-11-04,-7,ES
2554,Caldwell Heights,639,657,2014-11-04,-18,ES
2555,Callison,856,910,2014-11-04,-54,ES
2556,Canyon Creek,437,462,2014-11-04,-25,ES
2557,Canyon Vista,1377,1344,2014-11-04,33,MS
2558,Caraway,709,701,2014-11-04,8,ES
2559,Cedar Ridge,2716,2732,2014-11-04,-16,HS
2560,Cedar Valley,1314,1305,2014-11-04,9,MS
2561,Chandler Oaks,544,570,2014-11-04,-26,ES
2562,Chisholm Trail,1063,1019,2014-11-04,44,MS
2563,Deepwood,402,389,2014-11-04,13,ES
2564,Deerpark,931,983,2014-11-04,-52,MS
2565,Double File Trail,655,753,2014-11-04,-98,ES
2566,DAEP,2,7,2014-11-04,-5,Other
2567,England,801,805,2014-11-04,-4,ES
2568,Fern Bluff,677,719,2014-11-04,-42,ES
2569,Forest Creek,835,860,2014-11-04,-25,ES
2570,Forest North,410,444,2014-11-04,-34,ES
2571,Gattis,790,782,2014-11-04,8,ES
2572,Great Oaks,719,694,2014-11-04,25,ES
2573,Grisham,660,648,2014-11-04,12,MS
2574,Hernandez,830,848,2014-11-04,-18,MS
2575,Herrington,838,809,2014-11-04,29,ES
2576,Hopewell,966,899,2014-11-04,67,MS
2577,JJAEP,27,26,2014-11-04,1,Other
2578,Jollyville,458,444,2014-11-04,14,ES
2579,Laurel Mountain,775,767,2014-11-04,8,ES
2580,Live Oak,528,570,2014-11-04,-42,ES
2581,McNeil,2539,2556,2014-11-04,-17,HS
2582,Old Town,732,749,2014-11-04,-17,ES
2583,Pond Springs,651,641,2014-11-04,10,ES
2584,Purple Sage,320,343,2014-11-04,-23,ES
2585,Round Rock Opportunity Center,60,46,2014-11-04,14,Other
2586,Ridgeview,1373,1359,2014-11-04,14,MS
2587,Robertson,507,503,2014-11-04,4,ES
2588,Round Rock,2966,2995,2014-11-04,-29,HS
2589,Sommer,985,969,2014-11-04,16,ES
2590,Spicewood,795,785,2014-11-04,10,ES
2591,Stony Point,2460,2492,2014-11-04,-32,HS
2592,Success,317,128,2014-11-04,189,HS
2593,Teravista,872,883,2014-11-04,-11,ES
2594,Union Hill,849,877,2014-11-04,-28,ES
2595,Voigt,575,604,2014-11-04,-29,ES
2596,Walsh,1460,1455,2014-11-04,5,MS
2597,Wells Branch,935,1075,2014-11-04,-140,ES
2598,Westwood,2728,2721,2014-11-04,7,HS
2599,Anderson Mill,474,492,2014-11-11,-18,ES
2600,Berkman,496,548,2014-11-11,-52,ES
2601,Blackland Prairie,850,831,2014-11-11,19,ES
2602,Bluebonnet,578,591,2014-11-11,-13,ES
2603,Brushy Creek,780,778,2014-11-11,2,ES
2604,C.D. Fulkes,755,778,2014-11-11,-23,MS
2605,Cactus Ranch,1064,1071,2014-11-11,-7,ES
2606,Caldwell Heights,635,657,2014-11-11,-22,ES
2607,Callison,860,910,2014-11-11,-50,ES
2608,Canyon Creek,437,462,2014-11-11,-25,ES
2609,Canyon Vista,1377,1344,2014-11-11,33,MS
2610,Caraway,711,701,2014-11-11,10,ES
2611,Cedar Ridge,2714,2732,2014-11-11,-18,HS
2612,Cedar Valley,1313,1305,2014-11-11,8,MS
2613,Chandler Oaks,544,570,2014-11-11,-26,ES
2614,Chisholm Trail,1065,1019,2014-11-11,46,MS
2615,Deepwood,400,389,2014-11-11,11,ES
2616,Deerpark,928,983,2014-11-11,-55,MS
2617,Double File Trail,652,753,2014-11-11,-101,ES
2618,DAEP,4,7,2014-11-11,-3,Other
2619,England,800,805,2014-11-11,-5,ES
2620,Fern Bluff,677,719,2014-11-11,-42,ES
2621,Forest Creek,835,860,2014-11-11,-25,ES
2622,Forest North,413,444,2014-11-11,-31,ES
2623,Gattis,791,782,2014-11-11,9,ES
2624,Great Oaks,718,694,2014-11-11,24,ES
2625,Grisham,658,648,2014-11-11,10,MS
2626,Hernandez,823,848,2014-11-11,-25,MS
2627,Herrington,835,809,2014-11-11,26,ES
2628,Hopewell,969,899,2014-11-11,70,MS
2629,JJAEP,28,26,2014-11-11,2,Other
2630,Jollyville,457,444,2014-11-11,13,ES
2631,Laurel Mountain,778,767,2014-11-11,11,ES
2632,Live Oak,530,570,2014-11-11,-40,ES
2633,McNeil,2529,2556,2014-11-11,-27,HS
2634,Old Town,732,749,2014-11-11,-17,ES
2635,Pond Springs,650,641,2014-11-11,9,ES
2636,Purple Sage,324,343,2014-11-11,-19,ES
2637,Round Rock Opportunity Center,62,46,2014-11-11,16,Other
2638,Ridgeview,1372,1359,2014-11-11,13,MS
2639,Robertson,514,503,2014-11-11,11,ES
2640,Round Rock,2954,2995,2014-11-11,-41,HS
2641,Sommer,985,969,2014-11-11,16,ES
2642,Spicewood,795,785,2014-11-11,10,ES
2643,Stony Point,2463,2492,2014-11-11,-29,HS
2644,Success,325,128,2014-11-11,197,HS
2645,Teravista,873,883,2014-11-11,-10,ES
2646,Union Hill,849,877,2014-11-11,-28,ES
2647,Voigt,573,604,2014-11-11,-31,ES
2648,Walsh,1458,1455,2014-11-11,3,MS
2649,Wells Branch,933,1075,2014-11-11,-142,ES
2650,Westwood,2724,2721,2014-11-11,3,HS
2651,Anderson Mill,477,492,2014-11-18,-15,ES
2652,Berkman,493,548,2014-11-18,-55,ES
2653,Blackland Prairie,851,831,2014-11-18,20,ES
2654,Bluebonnet,575,591,2014-11-18,-16,ES
2655,Brushy Creek,779,778,2014-11-18,1,ES
2656,C.D. Fulkes,754,778,2014-11-18,-24,MS
2657,Cactus Ranch,1065,1071,2014-11-18,-6,ES
2658,Caldwell Heights,633,657,2014-11-18,-24,ES
2659,Callison,861,910,2014-11-18,-49,ES
2660,Canyon Creek,436,462,2014-11-18,-26,ES
2661,Canyon Vista,1376,1344,2014-11-18,32,MS
2662,Caraway,710,701,2014-11-18,9,ES
2663,Cedar Ridge,2713,2732,2014-11-18,-19,HS
2664,Cedar Valley,1312,1305,2014-11-18,7,MS
2665,Chandler Oaks,544,570,2014-11-18,-26,ES
2666,Chisholm Trail,1065,1019,2014-11-18,46,MS
2667,Deepwood,402,389,2014-11-18,13,ES
2668,Deerpark,925,983,2014-11-18,-58,MS
2669,Double File Trail,656,753,2014-11-18,-97,ES
2670,DAEP,6,7,2014-11-18,-1,Other
2671,England,802,805,2014-11-18,-3,ES
2672,Fern Bluff,678,719,2014-11-18,-41,ES
2673,Forest Creek,835,860,2014-11-18,-25,ES
2674,Forest North,412,444,2014-11-18,-32,ES
2675,Gattis,788,782,2014-11-18,6,ES
2676,Great Oaks,719,694,2014-11-18,25,ES
2677,Grisham,658,648,2014-11-18,10,MS
2678,Hernandez,821,848,2014-11-18,-27,MS
2679,Herrington,837,809,2014-11-18,28,ES
2680,Hopewell,968,899,2014-11-18,69,MS
2681,JJAEP,29,26,2014-11-18,3,Other
2682,Jollyville,459,444,2014-11-18,15,ES
2683,Laurel Mountain,779,767,2014-11-18,12,ES
2684,Live Oak,535,570,2014-11-18,-35,ES
2685,McNeil,2526,2556,2014-11-18,-30,HS
2686,Old Town,730,749,2014-11-18,-19,ES
2687,Pond Springs,649,641,2014-11-18,8,ES
2688,Purple Sage,325,343,2014-11-18,-18,ES
2689,Round Rock Opportunity Center,71,46,2014-11-18,25,Other
2690,Ridgeview,1373,1359,2014-11-18,14,MS
2691,Robertson,512,503,2014-11-18,9,ES
2692,Round Rock,2959,2995,2014-11-18,-36,HS
2693,Sommer,985,969,2014-11-18,16,ES
2694,Spicewood,796,785,2014-11-18,11,ES
2695,Stony Point,2459,2492,2014-11-18,-33,HS
2696,Success,315,128,2014-11-18,187,HS
2697,Teravista,871,883,2014-11-18,-12,ES
2698,Union Hill,846,877,2014-11-18,-31,ES
2699,Voigt,573,604,2014-11-18,-31,ES
2700,Walsh,1459,1455,2014-11-18,4,MS
2701,Wells Branch,931,1075,2014-11-18,-144,ES
2702,Westwood,2722,2721,2014-11-18,1,HS
2703,Anderson Mill,478,492,2014-11-25,-14,ES
2704,Berkman,493,548,2014-11-25,-55,ES
2705,Blackland Prairie,849,831,2014-11-25,18,ES
2706,Bluebonnet,575,591,2014-11-25,-16,ES
2707,Brushy Creek,779,778,2014-11-25,1,ES
2708,C.D. Fulkes,753,778,2014-11-25,-25,MS
2709,Cactus Ranch,1065,1071,2014-11-25,-6,ES
2710,Caldwell Heights,633,657,2014-11-25,-24,ES
2711,Callison,860,910,2014-11-25,-50,ES
2712,Canyon Creek,436,462,2014-11-25,-26,ES
2713,Canyon Vista,1374,1344,2014-11-25,30,MS
2714,Caraway,711,701,2014-11-25,10,ES
2715,Cedar Ridge,2712,2732,2014-11-25,-20,HS
2716,Cedar Valley,1312,1305,2014-11-25,7,MS
2717,Chandler Oaks,544,570,2014-11-25,-26,ES
2718,Chisholm Trail,1062,1019,2014-11-25,43,MS
2719,Deepwood,402,389,2014-11-25,13,ES
2720,Deerpark,925,983,2014-11-25,-58,MS
2721,Double File Trail,655,753,2014-11-25,-98,ES
2722,DAEP,6,7,2014-11-25,-1,Other
2723,England,803,805,2014-11-25,-2,ES
2724,Fern Bluff,676,719,2014-11-25,-43,ES
2725,Forest Creek,835,860,2014-11-25,-25,ES
2726,Forest North,411,444,2014-11-25,-33,ES
2727,Gattis,787,782,2014-11-25,5,ES
2728,Great Oaks,719,694,2014-11-25,25,ES
2729,Grisham,656,648,2014-11-25,8,MS
2730,Hernandez,821,848,2014-11-25,-27,MS
2731,Herrington,835,809,2014-11-25,26,ES
2732,Hopewell,967,899,2014-11-25,68,MS
2733,JJAEP,28,26,2014-11-25,2,Other
2734,Jollyville,459,444,2014-11-25,15,ES
2735,Laurel Mountain,779,767,2014-11-25,12,ES
2736,Live Oak,532,570,2014-11-25,-38,ES
2737,McNeil,2526,2556,2014-11-25,-30,HS
2738,Old Town,726,749,2014-11-25,-23,ES
2739,Pond Springs,650,641,2014-11-25,9,ES
2740,Purple Sage,325,343,2014-11-25,-18,ES
2741,Round Rock Opportunity Center,75,46,2014-11-25,29,Other
2742,Ridgeview,1374,1359,2014-11-25,15,MS
2743,Robertson,510,503,2014-11-25,7,ES
2744,Round Rock,2954,2995,2014-11-25,-41,HS
2745,Sommer,984,969,2014-11-25,15,ES
2746,Spicewood,796,785,2014-11-25,11,ES
2747,Stony Point,2454,2492,2014-11-25,-38,HS
2748,Success,320,128,2014-11-25,192,HS
2749,Teravista,872,883,2014-11-25,-11,ES
2750,Union Hill,842,877,2014-11-25,-35,ES
2751,Voigt,570,604,2014-11-25,-34,ES
2752,Walsh,1459,1455,2014-11-25,4,MS
2753,Wells Branch,934,1075,2014-11-25,-141,ES
2754,Westwood,2718,2721,2014-11-25,-3,HS
2755,Anderson Mill,478,492,2014-12-02,-14,ES
2756,Berkman,492,548,2014-12-02,-56,ES
2757,Blackland Prairie,850,831,2014-12-02,19,ES
2758,Bluebonnet,577,591,2014-12-02,-14,ES
2759,Brushy Creek,777,778,2014-12-02,-1,ES
2760,C.D. Fulkes,749,778,2014-12-02,-29,MS
2761,Cactus Ranch,1065,1071,2014-12-02,-6,ES
2762,Caldwell Heights,634,657,2014-12-02,-23,ES
2763,Callison,862,910,2014-12-02,-48,ES
2764,Canyon Creek,436,462,2014-12-02,-26,ES
2765,Canyon Vista,1374,1344,2014-12-02,30,MS
2766,Caraway,713,701,2014-12-02,12,ES
2767,Cedar Ridge,2712,2732,2014-12-02,-20,HS
2768,Cedar Valley,1312,1305,2014-12-02,7,MS
2769,Chandler Oaks,543,570,2014-12-02,-27,ES
2770,Chisholm Trail,1058,1019,2014-12-02,39,MS
2771,Deepwood,402,389,2014-12-02,13,ES
2772,Deerpark,928,983,2014-12-02,-55,MS
2773,Double File Trail,657,753,2014-12-02,-96,ES
2774,DAEP,5,7,2014-12-02,-2,Other
2775,England,807,805,2014-12-02,2,ES
2776,Fern Bluff,676,719,2014-12-02,-43,ES
2777,Forest Creek,836,860,2014-12-02,-24,ES
2778,Forest North,410,444,2014-12-02,-34,ES
2779,Gattis,788,782,2014-12-02,6,ES
2780,Great Oaks,721,694,2014-12-02,27,ES
2781,Grisham,659,648,2014-12-02,11,MS
2782,Hernandez,821,848,2014-12-02,-27,MS
2783,Herrington,836,809,2014-12-02,27,ES
2784,Hopewell,966,899,2014-12-02,67,MS
2785,JJAEP,27,26,2014-12-02,1,Other
2786,Jollyville,464,444,2014-12-02,20,ES
2787,Laurel Mountain,783,767,2014-12-02,16,ES
2788,Live Oak,534,570,2014-12-02,-36,ES
2789,McNeil,2529,2556,2014-12-02,-27,HS
2790,Old Town,728,749,2014-12-02,-21,ES
2791,Pond Springs,650,641,2014-12-02,9,ES
2792,Purple Sage,326,343,2014-12-02,-17,ES
2793,Round Rock Opportunity Center,73,46,2014-12-02,27,Other
2794,Ridgeview,1374,1359,2014-12-02,15,MS
2795,Robertson,506,503,2014-12-02,3,ES
2796,Round Rock,2958,2995,2014-12-02,-37,HS
2797,Sommer,984,969,2014-12-02,15,ES
2798,Spicewood,796,785,2014-12-02,11,ES
2799,Stony Point,2457,2492,2014-12-02,-35,HS
2800,Success,321,128,2014-12-02,193,HS
2801,Teravista,871,883,2014-12-02,-12,ES
2802,Union Hill,840,877,2014-12-02,-37,ES
2803,Voigt,568,604,2014-12-02,-36,ES
2804,Walsh,1460,1455,2014-12-02,5,MS
2805,Wells Branch,938,1075,2014-12-02,-137,ES
2806,Westwood,2719,2721,2014-12-02,-2,HS
2807,Anderson Mill,480,492,2014-12-09,-12,ES
2808,Berkman,494,548,2014-12-09,-54,ES
2809,Blackland Prairie,852,831,2014-12-09,21,ES
2810,Bluebonnet,580,591,2014-12-09,-11,ES
2811,Brushy Creek,778,778,2014-12-09,0,ES
2812,C.D. Fulkes,750,778,2014-12-09,-28,MS
2813,Cactus Ranch,1064,1071,2014-12-09,-7,ES
2814,Caldwell Heights,637,657,2014-12-09,-20,ES
2815,Callison,864,910,2014-12-09,-46,ES
2816,Canyon Creek,436,462,2014-12-09,-26,ES
2817,Canyon Vista,1376,1344,2014-12-09,32,MS
2818,Caraway,713,701,2014-12-09,12,ES
2819,Cedar Ridge,2707,2732,2014-12-09,-25,HS
2820,Cedar Valley,1313,1305,2014-12-09,8,MS
2821,Chandler Oaks,546,570,2014-12-09,-24,ES
2822,Chisholm Trail,1057,1019,2014-12-09,38,MS
2823,Deepwood,404,389,2014-12-09,15,ES
2824,Deerpark,930,983,2014-12-09,-53,MS
2825,Double File Trail,656,753,2014-12-09,-97,ES
2826,DAEP,8,7,2014-12-09,1,Other
2827,England,809,805,2014-12-09,4,ES
2828,Fern Bluff,676,719,2014-12-09,-43,ES
2829,Forest Creek,838,860,2014-12-09,-22,ES
2830,Forest North,409,444,2014-12-09,-35,ES
2831,Gattis,787,782,2014-12-09,5,ES
2832,Great Oaks,723,694,2014-12-09,29,ES
2833,Grisham,658,648,2014-12-09,10,MS
2834,Hernandez,822,848,2014-12-09,-26,MS
2835,Herrington,838,809,2014-12-09,29,ES
2836,Hopewell,969,899,2014-12-09,70,MS
2837,JJAEP,27,26,2014-12-09,1,Other
2838,Jollyville,467,444,2014-12-09,23,ES
2839,Laurel Mountain,783,767,2014-12-09,16,ES
2840,Live Oak,532,570,2014-12-09,-38,ES
2841,McNeil,2527,2556,2014-12-09,-29,HS
2842,Old Town,728,749,2014-12-09,-21,ES
2843,Pond Springs,650,641,2014-12-09,9,ES
2844,Purple Sage,329,343,2014-12-09,-14,ES
2845,Round Rock Opportunity Center,76,46,2014-12-09,30,Other
2846,Ridgeview,1377,1359,2014-12-09,18,MS
2847,Robertson,502,503,2014-12-09,-1,ES
2848,Round Rock,2951,2995,2014-12-09,-44,HS
2849,Sommer,989,969,2014-12-09,20,ES
2850,Spicewood,795,785,2014-12-09,10,ES
2851,Stony Point,2449,2492,2014-12-09,-43,HS
2852,Success,323,128,2014-12-09,195,HS
2853,Teravista,875,883,2014-12-09,-8,ES
2854,Union Hill,845,877,2014-12-09,-32,ES
2855,Voigt,566,604,2014-12-09,-38,ES
2856,Walsh,1462,1455,2014-12-09,7,MS
2857,Wells Branch,934,1075,2014-12-09,-141,ES
2858,Westwood,2718,2721,2014-12-09,-3,HS
2859,Anderson Mill,480,492,2014-12-16,-12,ES
2860,Berkman,498,548,2014-12-16,-50,ES
2861,Blackland Prairie,852,831,2014-12-16,21,ES
2862,Bluebonnet,581,591,2014-12-16,-10,ES
2863,Brushy Creek,778,778,2014-12-16,0,ES
2864,C.D. Fulkes,752,778,2014-12-16,-26,MS
2865,Cactus Ranch,1065,1071,2014-12-16,-6,ES
2866,Caldwell Heights,638,657,2014-12-16,-19,ES
2867,Callison,860,910,2014-12-16,-50,ES
2868,Canyon Creek,436,462,2014-12-16,-26,ES
2869,Canyon Vista,1372,1344,2014-12-16,28,MS
2870,Caraway,713,701,2014-12-16,12,ES
2871,Cedar Ridge,2706,2732,2014-12-16,-26,HS
2872,Cedar Valley,1313,1305,2014-12-16,8,MS
2873,Chandler Oaks,546,570,2014-12-16,-24,ES
2874,Chisholm Trail,1060,1019,2014-12-16,41,MS
2875,Deepwood,402,389,2014-12-16,13,ES
2876,Deerpark,933,983,2014-12-16,-50,MS
2877,Double File Trail,654,753,2014-12-16,-99,ES
2878,DAEP,9,7,2014-12-16,2,Other
2879,England,810,805,2014-12-16,5,ES
2880,Fern Bluff,678,719,2014-12-16,-41,ES
2881,Forest Creek,837,860,2014-12-16,-23,ES
2882,Forest North,405,444,2014-12-16,-39,ES
2883,Gattis,788,782,2014-12-16,6,ES
2884,Great Oaks,725,694,2014-12-16,31,ES
2885,Grisham,658,648,2014-12-16,10,MS
2886,Hernandez,821,848,2014-12-16,-27,MS
2887,Herrington,839,809,2014-12-16,30,ES
2888,Hopewell,968,899,2014-12-16,69,MS
2889,JJAEP,31,26,2014-12-16,5,Other
2890,Jollyville,466,444,2014-12-16,22,ES
2891,Laurel Mountain,782,767,2014-12-16,15,ES
2892,Live Oak,528,570,2014-12-16,-42,ES
2893,McNeil,2526,2556,2014-12-16,-30,HS
2894,Old Town,728,749,2014-12-16,-21,ES
2895,Pond Springs,650,641,2014-12-16,9,ES
2896,Purple Sage,329,343,2014-12-16,-14,ES
2897,Round Rock Opportunity Center,78,46,2014-12-16,32,Other
2898,Ridgeview,1375,1359,2014-12-16,16,MS
2899,Robertson,503,503,2014-12-16,0,ES
2900,Round Rock,2952,2995,2014-12-16,-43,HS
2901,Sommer,986,969,2014-12-16,17,ES
2902,Spicewood,794,785,2014-12-16,9,ES
2903,Stony Point,2445,2492,2014-12-16,-47,HS
2904,Success,323,128,2014-12-16,195,HS
2905,Teravista,873,883,2014-12-16,-10,ES
2906,Union Hill,840,877,2014-12-16,-37,ES
2907,Voigt,562,604,2014-12-16,-42,ES
2908,Walsh,1460,1455,2014-12-16,5,MS
2909,Wells Branch,940,1075,2014-12-16,-135,ES
2910,Westwood,2717,2721,2014-12-16,-4,HS
2911,Anderson Mill,472,492,2015-01-06,-20,ES
2912,Berkman,496,548,2015-01-06,-52,ES
2913,Blackland Prairie,855,831,2015-01-06,24,ES
2914,Bluebonnet,598,591,2015-01-06,7,ES
2915,Brushy Creek,778,778,2015-01-06,0,ES
2916,C.D. Fulkes,752,778,2015-01-06,-26,MS
2917,Cactus Ranch,1068,1071,2015-01-06,-3,ES
2918,Caldwell Heights,639,657,2015-01-06,-18,ES
2919,Callison,857,910,2015-01-06,-53,ES
2920,Canyon Creek,436,462,2015-01-06,-26,ES
2921,Canyon Vista,1372,1344,2015-01-06,28,MS
2922,Caraway,726,701,2015-01-06,25,ES
2923,Cedar Ridge,2706,2732,2015-01-06,-26,HS
2924,Cedar Valley,1313,1305,2015-01-06,8,MS
2925,Chandler Oaks,547,570,2015-01-06,-23,ES
2926,Chisholm Trail,1060,1019,2015-01-06,41,MS
2927,Deepwood,406,389,2015-01-06,17,ES
2928,Deerpark,933,983,2015-01-06,-50,MS
2929,Double File Trail,657,753,2015-01-06,-96,ES
2930,DAEP,5,7,2015-01-06,-2,Other
2931,England,819,805,2015-01-06,14,ES
2932,Fern Bluff,684,719,2015-01-06,-35,ES
2933,Forest Creek,834,860,2015-01-06,-26,ES
2934,Forest North,402,444,2015-01-06,-42,ES
2935,Gattis,792,782,2015-01-06,10,ES
2936,Great Oaks,732,694,2015-01-06,38,ES
2937,Grisham,658,648,2015-01-06,10,MS
2938,Hernandez,821,848,2015-01-06,-27,MS
2939,Herrington,842,809,2015-01-06,33,ES
2940,Hopewell,968,899,2015-01-06,69,MS
2941,JJAEP,31,26,2015-01-06,5,Other
2942,Jollyville,467,444,2015-01-06,23,ES
2943,Laurel Mountain,780,767,2015-01-06,13,ES
2944,Live Oak,532,570,2015-01-06,-38,ES
2945,McNeil,2526,2556,2015-01-06,-30,HS
2946,Old Town,733,749,2015-01-06,-16,ES
2947,Pond Springs,651,641,2015-01-06,10,ES
2948,Purple Sage,333,343,2015-01-06,-10,ES
2949,Round Rock Opportunity Center,78,46,2015-01-06,32,Other
2950,Ridgeview,1375,1359,2015-01-06,16,MS
2951,Robertson,501,503,2015-01-06,-2,ES
2952,Round Rock,2952,2995,2015-01-06,-43,HS
2953,Sommer,987,969,2015-01-06,18,ES
2954,Spicewood,800,785,2015-01-06,15,ES
2955,Stony Point,2445,2492,2015-01-06,-47,HS
2956,Success,323,128,2015-01-06,195,HS
2957,Teravista,882,883,2015-01-06,-1,ES
2958,Union Hill,833,877,2015-01-06,-44,ES
2959,Voigt,559,604,2015-01-06,-45,ES
2960,Walsh,1460,1455,2015-01-06,5,MS
2961,Wells Branch,935,1075,2015-01-06,-140,ES
2962,Westwood,2717,2721,2015-01-06,-4,HS
2963,Anderson Mill,474,492,2015-01-13,-18,ES
2964,Berkman,496,548,2015-01-13,-52,ES
2965,Blackland Prairie,858,831,2015-01-13,27,ES
2966,Bluebonnet,597,591,2015-01-13,6,ES
2967,Brushy Creek,784,778,2015-01-13,6,ES
2968,C.D. Fulkes,746,778,2015-01-13,-32,MS
2969,Cactus Ranch,1069,1071,2015-01-13,-2,ES
2970,Caldwell Heights,641,657,2015-01-13,-16,ES
2971,Callison,859,910,2015-01-13,-51,ES
2972,Canyon Creek,434,462,2015-01-13,-28,ES
2973,Canyon Vista,1433,1344,2015-01-13,89,MS
2974,Caraway,717,701,2015-01-13,16,ES
2975,Cedar Ridge,2704,2732,2015-01-13,-28,HS
2976,Cedar Valley,1319,1305,2015-01-13,14,MS
2977,Chandler Oaks,548,570,2015-01-13,-22,ES
2978,Chisholm Trail,1065,1019,2015-01-13,46,MS
2979,Deepwood,396,389,2015-01-13,7,ES
2980,Deerpark,927,983,2015-01-13,-56,MS
2981,Double File Trail,660,753,2015-01-13,-93,ES
2982,DAEP,5,7,2015-01-13,-2,Other
2983,England,822,805,2015-01-13,17,ES
2984,Fern Bluff,684,719,2015-01-13,-35,ES
2985,Forest Creek,834,860,2015-01-13,-26,ES
2986,Forest North,406,444,2015-01-13,-38,ES
2987,Gattis,791,782,2015-01-13,9,ES
2988,Great Oaks,731,694,2015-01-13,37,ES
2989,Grisham,664,648,2015-01-13,16,MS
2990,Hernandez,809,848,2015-01-13,-39,MS
2991,Herrington,847,809,2015-01-13,38,ES
2992,Hopewell,973,899,2015-01-13,74,MS
2993,JJAEP,22,26,2015-01-13,-4,Other
2994,Jollyville,468,444,2015-01-13,24,ES
2995,Laurel Mountain,781,767,2015-01-13,14,ES
2996,Live Oak,538,570,2015-01-13,-32,ES
2997,McNeil,2518,2556,2015-01-13,-38,HS
2998,Old Town,726,749,2015-01-13,-23,ES
2999,Pond Springs,651,641,2015-01-13,10,ES
3000,Purple Sage,321,343,2015-01-13,-22,ES
3001,Round Rock Opportunity Center,84,46,2015-01-13,38,Other
3002,Ridgeview,1371,1359,2015-01-13,12,MS
3003,Robertson,501,503,2015-01-13,-2,ES
3004,Round Rock,2943,2995,2015-01-13,-52,HS
3005,Sommer,991,969,2015-01-13,22,ES
3006,Spicewood,801,785,2015-01-13,16,ES
3007,Stony Point,2428,2492,2015-01-13,-64,HS
3008,Success,338,128,2015-01-13,210,HS
3009,Teravista,874,883,2015-01-13,-9,ES
3010,Union Hill,835,877,2015-01-13,-42,ES
3011,Voigt,564,604,2015-01-13,-40,ES
3012,Walsh,1461,1455,2015-01-13,6,MS
3013,Wells Branch,951,1075,2015-01-13,-124,ES
3014,Westwood,2721,2721,2015-01-13,0,HS
3015,Anderson Mill,476,492,2015-01-20,-16,ES
3016,Berkman,499,548,2015-01-20,-49,ES
3017,Blackland Prairie,859,831,2015-01-20,28,ES
3018,Bluebonnet,600,591,2015-01-20,9,ES
3019,Brushy Creek,782,778,2015-01-20,4,ES
3020,C.D. Fulkes,744,778,2015-01-20,-34,MS
3021,Cactus Ranch,1070,1071,2015-01-20,-1,ES
3022,Caldwell Heights,636,657,2015-01-20,-21,ES
3023,Callison,854,910,2015-01-20,-56,ES
3024,Canyon Creek,434,462,2015-01-20,-28,ES
3025,Canyon Vista,1365,1344,2015-01-20,21,MS
3026,Caraway,719,701,2015-01-20,18,ES
3027,Cedar Ridge,2701,2732,2015-01-20,-31,HS
3028,Cedar Valley,1320,1305,2015-01-20,15,MS
3029,Chandler Oaks,547,570,2015-01-20,-23,ES
3030,Chisholm Trail,1065,1019,2015-01-20,46,MS
3031,Deepwood,394,389,2015-01-20,5,ES
3032,Deerpark,927,983,2015-01-20,-56,MS
3033,Double File Trail,661,753,2015-01-20,-92,ES
3034,DAEP,5,7,2015-01-20,-2,Other
3035,England,823,805,2015-01-20,18,ES
3036,Fern Bluff,684,719,2015-01-20,-35,ES
3037,Forest Creek,834,860,2015-01-20,-26,ES
3038,Forest North,406,444,2015-01-20,-38,ES
3039,Gattis,794,782,2015-01-20,12,ES
3040,Great Oaks,732,694,2015-01-20,38,ES
3041,Grisham,662,648,2015-01-20,14,MS
3042,Hernandez,812,848,2015-01-20,-36,MS
3043,Herrington,847,809,2015-01-20,38,ES
3044,Hopewell,972,899,2015-01-20,73,MS
3045,JJAEP,20,26,2015-01-20,-6,Other
3046,Jollyville,468,444,2015-01-20,24,ES
3047,Laurel Mountain,781,767,2015-01-20,14,ES
3048,Live Oak,541,570,2015-01-20,-29,ES
3049,McNeil,2506,2556,2015-01-20,-50,HS
3050,Old Town,725,749,2015-01-20,-24,ES
3051,Pond Springs,651,641,2015-01-20,10,ES
3052,Purple Sage,321,343,2015-01-20,-22,ES
3053,Round Rock Opportunity Center,82,46,2015-01-20,36,Other
3054,Ridgeview,1369,1359,2015-01-20,10,MS
3055,Robertson,499,503,2015-01-20,-4,ES
3056,Round Rock,2938,2995,2015-01-20,-57,HS
3057,Sommer,994,969,2015-01-20,25,ES
3058,Spicewood,801,785,2015-01-20,16,ES
3059,Stony Point,2421,2492,2015-01-20,-71,HS
3060,Success,357,128,2015-01-20,229,HS
3061,Teravista,872,883,2015-01-20,-11,ES
3062,Union Hill,832,877,2015-01-20,-45,ES
3063,Voigt,565,604,2015-01-20,-39,ES
3064,Walsh,1460,1455,2015-01-20,5,MS
3065,Wells Branch,954,1075,2015-01-20,-121,ES
3066,Westwood,2706,2721,2015-01-20,-15,HS
3067,Anderson Mill,480,492,2015-01-27,-12,ES
3068,Berkman,500,548,2015-01-27,-48,ES
3069,Blackland Prairie,856,831,2015-01-27,25,ES
3070,Bluebonnet,599,591,2015-01-27,8,ES
3071,Brushy Creek,782,778,2015-01-27,4,ES
3072,C.D. Fulkes,746,778,2015-01-27,-32,MS
3073,Cactus Ranch,1071,1071,2015-01-27,0,ES
3074,Caldwell Heights,639,657,2015-01-27,-18,ES
3075,Callison,850,910,2015-01-27,-60,ES
3076,Canyon Creek,436,462,2015-01-27,-26,ES
3077,Canyon Vista,1362,1344,2015-01-27,18,MS
3078,Caraway,714,701,2015-01-27,13,ES
3079,Cedar Ridge,2694,2732,2015-01-27,-38,HS
3080,Cedar Valley,1323,1305,2015-01-27,18,MS
3081,Chandler Oaks,548,570,2015-01-27,-22,ES
3082,Chisholm Trail,1069,1019,2015-01-27,50,MS
3083,Deepwood,396,389,2015-01-27,7,ES
3084,Deerpark,927,983,2015-01-27,-56,MS
3085,Double File Trail,663,753,2015-01-27,-90,ES
3086,DAEP,3,7,2015-01-27,-4,Other
3087,England,823,805,2015-01-27,18,ES
3088,Fern Bluff,684,719,2015-01-27,-35,ES
3089,Forest Creek,830,860,2015-01-27,-30,ES
3090,Forest North,409,444,2015-01-27,-35,ES
3091,Gattis,798,782,2015-01-27,16,ES
3092,Great Oaks,731,694,2015-01-27,37,ES
3093,Grisham,663,648,2015-01-27,15,MS
3094,Hernandez,812,848,2015-01-27,-36,MS
3095,Herrington,845,809,2015-01-27,36,ES
3096,Hopewell,969,899,2015-01-27,70,MS
3097,JJAEP,22,26,2015-01-27,-4,Other
3098,Jollyville,470,444,2015-01-27,26,ES
3099,Laurel Mountain,782,767,2015-01-27,15,ES
3100,Live Oak,540,570,2015-01-27,-30,ES
3101,McNeil,2496,2556,2015-01-27,-60,HS
3102,Old Town,723,749,2015-01-27,-26,ES
3103,Pond Springs,653,641,2015-01-27,12,ES
3104,Purple Sage,322,343,2015-01-27,-21,ES
3105,Round Rock Opportunity Center,81,46,2015-01-27,35,Other
3106,Ridgeview,1368,1359,2015-01-27,9,MS
3107,Robertson,499,503,2015-01-27,-4,ES
3108,Round Rock,2933,2995,2015-01-27,-62,HS
3109,Sommer,999,969,2015-01-27,30,ES
3110,Spicewood,803,785,2015-01-27,18,ES
3111,Stony Point,2417,2492,2015-01-27,-75,HS
3112,Success,379,128,2015-01-27,251,HS
3113,Teravista,872,883,2015-01-27,-11,ES
3114,Union Hill,833,877,2015-01-27,-44,ES
3115,Voigt,568,604,2015-01-27,-36,ES
3116,Walsh,1461,1455,2015-01-27,6,MS
3117,Wells Branch,957,1075,2015-01-27,-118,ES
3118,Westwood,2699,2721,2015-01-27,-22,HS
3119,Anderson Mill,481,492,2015-02-03,-11,ES
3120,Berkman,500,548,2015-02-03,-48,ES
3121,Blackland Prairie,857,831,2015-02-03,26,ES
3122,Bluebonnet,598,591,2015-02-03,7,ES
3123,Brushy Creek,783,778,2015-02-03,5,ES
3124,C.D. Fulkes,742,778,2015-02-03,-36,MS
3125,Cactus Ranch,1073,1071,2015-02-03,2,ES
3126,Caldwell Heights,640,657,2015-02-03,-17,ES
3127,Callison,846,910,2015-02-03,-64,ES
3128,Canyon Creek,436,462,2015-02-03,-26,ES
3129,Canyon Vista,1360,1344,2015-02-03,16,MS
3130,Caraway,714,701,2015-02-03,13,ES
3131,Cedar Ridge,2681,2732,2015-02-03,-51,HS
3132,Cedar Valley,1323,1305,2015-02-03,18,MS
3133,Chandler Oaks,548,570,2015-02-03,-22,ES
3134,Chisholm Trail,1064,1019,2015-02-03,45,MS
3135,Deepwood,395,389,2015-02-03,6,ES
3136,Deerpark,921,983,2015-02-03,-62,MS
3137,Double File Trail,664,753,2015-02-03,-89,ES
3138,DAEP,4,7,2015-02-03,-3,Other
3139,England,823,805,2015-02-03,18,ES
3140,Fern Bluff,684,719,2015-02-03,-35,ES
3141,Forest Creek,832,860,2015-02-03,-28,ES
3142,Forest North,407,444,2015-02-03,-37,ES
3143,Gattis,797,782,2015-02-03,15,ES
3144,Great Oaks,733,694,2015-02-03,39,ES
3145,Grisham,659,648,2015-02-03,11,MS
3146,Hernandez,810,848,2015-02-03,-38,MS
3147,Herrington,845,809,2015-02-03,36,ES
3148,Hopewell,970,899,2015-02-03,71,MS
3149,JJAEP,23,26,2015-02-03,-3,Other
3150,Jollyville,467,444,2015-02-03,23,ES
3151,Laurel Mountain,783,767,2015-02-03,16,ES
3152,Live Oak,537,570,2015-02-03,-33,ES
3153,McNeil,2494,2556,2015-02-03,-62,HS
3154,Old Town,723,749,2015-02-03,-26,ES
3155,Pond Springs,653,641,2015-02-03,12,ES
3156,Purple Sage,320,343,2015-02-03,-23,ES
3157,Round Rock Opportunity Center,84,46,2015-02-03,38,Other
3158,Ridgeview,1367,1359,2015-02-03,8,MS
3159,Robertson,499,503,2015-02-03,-4,ES
3160,Round Rock,2936,2995,2015-02-03,-59,HS
3161,Sommer,999,969,2015-02-03,30,ES
3162,Spicewood,804,785,2015-02-03,19,ES
3163,Stony Point,2418,2492,2015-02-03,-74,HS
3164,Success,384,128,2015-02-03,256,HS
3165,Teravista,871,883,2015-02-03,-12,ES
3166,Union Hill,837,877,2015-02-03,-40,ES
3167,Voigt,567,604,2015-02-03,-37,ES
3168,Walsh,1460,1455,2015-02-03,5,MS
3169,Wells Branch,951,1075,2015-02-03,-124,ES
3170,Westwood,2693,2721,2015-02-03,-28,HS
3171,Anderson Mill,482,492,2015-02-10,-10,ES
3172,Berkman,498,548,2015-02-10,-50,ES
3173,Blackland Prairie,859,831,2015-02-10,28,ES
3174,Bluebonnet,597,591,2015-02-10,6,ES
3175,Brushy Creek,784,778,2015-02-10,6,ES
3176,C.D. Fulkes,745,778,2015-02-10,-33,MS
3177,Cactus Ranch,1073,1071,2015-02-10,2,ES
3178,Caldwell Heights,640,657,2015-02-10,-17,ES
3179,Callison,851,910,2015-02-10,-59,ES
3180,Canyon Creek,434,462,2015-02-10,-28,ES
3181,Canyon Vista,1359,1344,2015-02-10,15,MS
3182,Caraway,714,701,2015-02-10,13,ES
3183,Cedar Ridge,2684,2732,2015-02-10,-48,HS
3184,Cedar Valley,1324,1305,2015-02-10,19,MS
3185,Chandler Oaks,552,570,2015-02-10,-18,ES
3186,Chisholm Trail,1066,1019,2015-02-10,47,MS
3187,Deepwood,395,389,2015-02-10,6,ES
3188,Deerpark,922,983,2015-02-10,-61,MS
3189,Double File Trail,660,753,2015-02-10,-93,ES
3190,DAEP,5,7,2015-02-10,-2,Other
3191,England,827,805,2015-02-10,22,ES
3192,Fern Bluff,683,719,2015-02-10,-36,ES
3193,Forest Creek,833,860,2015-02-10,-27,ES
3194,Forest North,408,444,2015-02-10,-36,ES
3195,Gattis,797,782,2015-02-10,15,ES
3196,Great Oaks,732,694,2015-02-10,38,ES
3197,Grisham,660,648,2015-02-10,12,MS
3198,Hernandez,808,848,2015-02-10,-40,MS
3199,Herrington,845,809,2015-02-10,36,ES
3200,Hopewell,968,899,2015-02-10,69,MS
3201,JJAEP,24,26,2015-02-10,-2,Other
3202,Jollyville,468,444,2015-02-10,24,ES
3203,Laurel Mountain,783,767,2015-02-10,16,ES
3204,Live Oak,537,570,2015-02-10,-33,ES
3205,McNeil,2496,2556,2015-02-10,-60,HS
3206,Old Town,722,749,2015-02-10,-27,ES
3207,Pond Springs,652,641,2015-02-10,11,ES
3208,Purple Sage,322,343,2015-02-10,-21,ES
3209,Round Rock Opportunity Center,89,46,2015-02-10,43,Other
3210,Ridgeview,1369,1359,2015-02-10,10,MS
3211,Robertson,498,503,2015-02-10,-5,ES
3212,Round Rock,2935,2995,2015-02-10,-60,HS
3213,Sommer,998,969,2015-02-10,29,ES
3214,Spicewood,805,785,2015-02-10,20,ES
3215,Stony Point,2416,2492,2015-02-10,-76,HS
3216,Success,381,128,2015-02-10,253,HS
3217,Teravista,868,883,2015-02-10,-15,ES
3218,Union Hill,840,877,2015-02-10,-37,ES
3219,Voigt,571,604,2015-02-10,-33,ES
3220,Walsh,1458,1455,2015-02-10,3,MS
3221,Wells Branch,951,1075,2015-02-10,-124,ES
3222,Westwood,2693,2721,2015-02-10,-28,HS
3223,Anderson Mill,483,492,2015-02-17,-9,ES
3224,Berkman,499,548,2015-02-17,-49,ES
3225,Blackland Prairie,859,831,2015-02-17,28,ES
3226,Bluebonnet,598,591,2015-02-17,7,ES
3227,Brushy Creek,784,778,2015-02-17,6,ES
3228,C.D. Fulkes,741,778,2015-02-17,-37,MS
3229,Cactus Ranch,1073,1071,2015-02-17,2,ES
3230,Caldwell Heights,639,657,2015-02-17,-18,ES
3231,Callison,849,910,2015-02-17,-61,ES
3232,Canyon Creek,433,462,2015-02-17,-29,ES
3233,Canyon Vista,1361,1344,2015-02-17,17,MS
3234,Caraway,713,701,2015-02-17,12,ES
3235,Cedar Ridge,2688,2732,2015-02-17,-44,HS
3236,Cedar Valley,1323,1305,2015-02-17,18,MS
3237,Chandler Oaks,550,570,2015-02-17,-20,ES
3238,Chisholm Trail,1066,1019,2015-02-17,47,MS
3239,Deepwood,393,389,2015-02-17,4,ES
3240,Deerpark,920,983,2015-02-17,-63,MS
3241,Double File Trail,657,753,2015-02-17,-96,ES
3242,DAEP,8,7,2015-02-17,1,Other
3243,England,829,805,2015-02-17,24,ES
3244,Fern Bluff,681,719,2015-02-17,-38,ES
3245,Forest Creek,834,860,2015-02-17,-26,ES
3246,Forest North,406,444,2015-02-17,-38,ES
3247,Gattis,797,782,2015-02-17,15,ES
3248,Great Oaks,739,694,2015-02-17,45,ES
3249,Grisham,664,648,2015-02-17,16,MS
3250,Hernandez,809,848,2015-02-17,-39,MS
3251,Herrington,849,809,2015-02-17,40,ES
3252,Hopewell,969,899,2015-02-17,70,MS
3253,JJAEP,21,26,2015-02-17,-5,Other
3254,Jollyville,466,444,2015-02-17,22,ES
3255,Laurel Mountain,786,767,2015-02-17,19,ES
3256,Live Oak,536,570,2015-02-17,-34,ES
3257,McNeil,2494,2556,2015-02-17,-62,HS
3258,Old Town,721,749,2015-02-17,-28,ES
3259,Pond Springs,649,641,2015-02-17,8,ES
3260,Purple Sage,321,343,2015-02-17,-22,ES
3261,Round Rock Opportunity Center,90,46,2015-02-17,44,Other
3262,Ridgeview,1369,1359,2015-02-17,10,MS
3263,Robertson,495,503,2015-02-17,-8,ES
3264,Round Rock,2933,2995,2015-02-17,-62,HS
3265,Sommer,999,969,2015-02-17,30,ES
3266,Spicewood,805,785,2015-02-17,20,ES
3267,Stony Point,2411,2492,2015-02-17,-81,HS
3268,Success,376,128,2015-02-17,248,HS
3269,Teravista,870,883,2015-02-17,-13,ES
3270,Union Hill,838,877,2015-02-17,-39,ES
3271,Voigt,572,604,2015-02-17,-32,ES
3272,Walsh,1459,1455,2015-02-17,4,MS
3273,Wells Branch,953,1075,2015-02-17,-122,ES
3274,Westwood,2689,2721,2015-02-17,-32,HS
3275,Anderson Mill,485,492,2015-03-03,-7,ES
3276,Berkman,496,548,2015-03-03,-52,ES
3277,Blackland Prairie,856,831,2015-03-03,25,ES
3278,Bluebonnet,599,591,2015-03-03,8,ES
3279,Brushy Creek,785,778,2015-03-03,7,ES
3280,C.D. Fulkes,736,778,2015-03-03,-42,MS
3281,Cactus Ranch,1073,1071,2015-03-03,2,ES
3282,Caldwell Heights,637,657,2015-03-03,-20,ES
3283,Callison,853,910,2015-03-03,-57,ES
3284,Canyon Creek,433,462,2015-03-03,-29,ES
3285,Canyon Vista,1360,1344,2015-03-03,16,MS
3286,Caraway,709,701,2015-03-03,8,ES
3287,Cedar Ridge,2681,2732,2015-03-03,-51,HS
3288,Cedar Valley,1322,1305,2015-03-03,17,MS
3289,Chandler Oaks,550,570,2015-03-03,-20,ES
3290,Chisholm Trail,1064,1019,2015-03-03,45,MS
3291,Deepwood,391,389,2015-03-03,2,ES
3292,Deerpark,918,983,2015-03-03,-65,MS
3293,Double File Trail,661,753,2015-03-03,-92,ES
3294,DAEP,8,7,2015-03-03,1,Other
3295,England,832,805,2015-03-03,27,ES
3296,Fern Bluff,683,719,2015-03-03,-36,ES
3297,Forest Creek,833,860,2015-03-03,-27,ES
3298,Forest North,410,444,2015-03-03,-34,ES
3299,Gattis,784,782,2015-03-03,2,ES
3300,Great Oaks,740,694,2015-03-03,46,ES
3301,Grisham,666,648,2015-03-03,18,MS
3302,Hernandez,816,848,2015-03-03,-32,MS
3303,Herrington,847,809,2015-03-03,38,ES
3304,Hopewell,972,899,2015-03-03,73,MS
3305,JJAEP,25,26,2015-03-03,-1,Other
3306,Jollyville,468,444,2015-03-03,24,ES
3307,Laurel Mountain,785,767,2015-03-03,18,ES
3308,Live Oak,536,570,2015-03-03,-34,ES
3309,McNeil,2484,2556,2015-03-03,-72,HS
3310,Old Town,720,749,2015-03-03,-29,ES
3311,Pond Springs,648,641,2015-03-03,7,ES
3312,Purple Sage,317,343,2015-03-03,-26,ES
3313,Round Rock Opportunity Center,90,46,2015-03-03,44,Other
3314,Ridgeview,1377,1359,2015-03-03,18,MS
3315,Robertson,498,503,2015-03-03,-5,ES
3316,Round Rock,2916,2995,2015-03-03,-79,HS
3317,Sommer,999,969,2015-03-03,30,ES
3318,Spicewood,806,785,2015-03-03,21,ES
3319,Stony Point,2412,2492,2015-03-03,-80,HS
3320,Success,371,128,2015-03-03,243,HS
3321,Teravista,873,883,2015-03-03,-10,ES
3322,Union Hill,833,877,2015-03-03,-44,ES
3323,Voigt,577,604,2015-03-03,-27,ES
3324,Walsh,1464,1455,2015-03-03,9,MS
3325,Wells Branch,959,1075,2015-03-03,-116,ES
3326,Westwood,2686,2721,2015-03-03,-35,HS
3327,Anderson Mill,487,492,2015-03-10,-5,ES
3328,Berkman,497,548,2015-03-10,-51,ES
3329,Blackland Prairie,856,831,2015-03-10,25,ES
3330,Bluebonnet,601,591,2015-03-10,10,ES
3331,Brushy Creek,786,778,2015-03-10,8,ES
3332,C.D. Fulkes,737,778,2015-03-10,-41,MS
3333,Cactus Ranch,1075,1071,2015-03-10,4,ES
3334,Caldwell Heights,637,657,2015-03-10,-20,ES
3335,Callison,848,910,2015-03-10,-62,ES
3336,Canyon Creek,433,462,2015-03-10,-29,ES
3337,Canyon Vista,1359,1344,2015-03-10,15,MS
3338,Caraway,712,701,2015-03-10,11,ES
3339,Cedar Ridge,2679,2732,2015-03-10,-53,HS
3340,Cedar Valley,1321,1305,2015-03-10,16,MS
3341,Chandler Oaks,551,570,2015-03-10,-19,ES
3342,Chisholm Trail,1066,1019,2015-03-10,47,MS
3343,Deepwood,394,389,2015-03-10,5,ES
3344,Deerpark,920,983,2015-03-10,-63,MS
3345,Double File Trail,662,753,2015-03-10,-91,ES
3346,DAEP,8,7,2015-03-10,1,Other
3347,England,833,805,2015-03-10,28,ES
3348,Fern Bluff,683,719,2015-03-10,-36,ES
3349,Forest Creek,834,860,2015-03-10,-26,ES
3350,Forest North,408,444,2015-03-10,-36,ES
3351,Gattis,784,782,2015-03-10,2,ES
3352,Great Oaks,739,694,2015-03-10,45,ES
3353,Grisham,666,648,2015-03-10,18,MS
3354,Hernandez,818,848,2015-03-10,-30,MS
3355,Herrington,850,809,2015-03-10,41,ES
3356,Hopewell,975,899,2015-03-10,76,MS
3357,JJAEP,25,26,2015-03-10,-1,Other
3358,Jollyville,463,444,2015-03-10,19,ES
3359,Laurel Mountain,785,767,2015-03-10,18,ES
3360,Live Oak,535,570,2015-03-10,-35,ES
3361,McNeil,2487,2556,2015-03-10,-69,HS
3362,Old Town,720,749,2015-03-10,-29,ES
3363,Pond Springs,650,641,2015-03-10,9,ES
3364,Purple Sage,319,343,2015-03-10,-24,ES
3365,Round Rock Opportunity Center,93,46,2015-03-10,47,Other
3366,Ridgeview,1377,1359,2015-03-10,18,MS
3367,Robertson,495,503,2015-03-10,-8,ES
3368,Round Rock,2912,2995,2015-03-10,-83,HS
3369,Sommer,999,969,2015-03-10,30,ES
3370,Spicewood,806,785,2015-03-10,21,ES
3371,Stony Point,2403,2492,2015-03-10,-89,HS
3372,Success,372,128,2015-03-10,244,HS
3373,Teravista,875,883,2015-03-10,-8,ES
3374,Union Hill,833,877,2015-03-10,-44,ES
3375,Voigt,577,604,2015-03-10,-27,ES
3376,Walsh,1464,1455,2015-03-10,9,MS
3377,Wells Branch,957,1075,2015-03-10,-118,ES
3378,Westwood,2686,2721,2015-03-10,-35,HS
3379,Anderson Mill,488,492,2015-03-24,-4,ES
3380,Berkman,493,548,2015-03-24,-55,ES
3381,Blackland Prairie,858,831,2015-03-24,27,ES
3382,Bluebonnet,606,591,2015-03-24,15,ES
3383,Brushy Creek,783,778,2015-03-24,5,ES
3384,C.D. Fulkes,737,778,2015-03-24,-41,MS
3385,Cactus Ranch,1075,1071,2015-03-24,4,ES
3386,Caldwell Heights,644,657,2015-03-24,-13,ES
3387,Callison,843,910,2015-03-24,-67,ES
3388,Canyon Creek,431,462,2015-03-24,-31,ES
3389,Canyon Vista,1357,1344,2015-03-24,13,MS
3390,Caraway,711,701,2015-03-24,10,ES
3391,Cedar Ridge,2673,2732,2015-03-24,-59,HS
3392,Cedar Valley,1323,1305,2015-03-24,18,MS
3393,Chandler Oaks,551,570,2015-03-24,-19,ES
3394,Chisholm Trail,1062,1019,2015-03-24,43,MS
3395,Deepwood,395,389,2015-03-24,6,ES
3396,Deerpark,921,983,2015-03-24,-62,MS
3397,Double File Trail,666,753,2015-03-24,-87,ES
3398,DAEP,8,7,2015-03-24,1,Other
3399,England,835,805,2015-03-24,30,ES
3400,Fern Bluff,683,719,2015-03-24,-36,ES
3401,Forest Creek,834,860,2015-03-24,-26,ES
3402,Forest North,409,444,2015-03-24,-35,ES
3403,Gattis,779,782,2015-03-24,-3,ES
3404,Great Oaks,740,694,2015-03-24,46,ES
3405,Grisham,668,648,2015-03-24,20,MS
3406,Hernandez,823,848,2015-03-24,-25,MS
3407,Herrington,855,809,2015-03-24,46,ES
3408,Hopewell,972,899,2015-03-24,73,MS
3409,JJAEP,27,26,2015-03-24,1,Other
3410,Jollyville,469,444,2015-03-24,25,ES
3411,Laurel Mountain,790,767,2015-03-24,23,ES
3412,Live Oak,532,570,2015-03-24,-38,ES
3413,McNeil,2477,2556,2015-03-24,-79,HS
3414,Old Town,721,749,2015-03-24,-28,ES
3415,Pond Springs,649,641,2015-03-24,8,ES
3416,Purple Sage,320,343,2015-03-24,-23,ES
3417,Round Rock Opportunity Center,89,46,2015-03-24,43,Other
3418,Ridgeview,1374,1359,2015-03-24,15,MS
3419,Robertson,495,503,2015-03-24,-8,ES
3420,Round Rock,2906,2995,2015-03-24,-89,HS
3421,Sommer,1000,969,2015-03-24,31,ES
3422,Spicewood,807,785,2015-03-24,22,ES
3423,Stony Point,2400,2492,2015-03-24,-92,HS
3424,Success,368,128,2015-03-24,240,HS
3425,Teravista,878,883,2015-03-24,-5,ES
3426,Union Hill,832,877,2015-03-24,-45,ES
3427,Voigt,577,604,2015-03-24,-27,ES
3428,Walsh,1464,1455,2015-03-24,9,MS
3429,Wells Branch,951,1075,2015-03-24,-124,ES
3430,Westwood,2687,2721,2015-03-24,-34,HS
3431,Anderson Mill,488,492,2015-03-31,-4,ES
3432,Berkman,493,548,2015-03-31,-55,ES
3433,Blackland Prairie,858,831,2015-03-31,27,ES
3434,Bluebonnet,606,591,2015-03-31,15,ES
3435,Brushy Creek,783,778,2015-03-31,5,ES
3436,C.D. Fulkes,737,778,2015-03-31,-41,MS
3437,Cactus Ranch,1075,1071,2015-03-31,4,ES
3438,Caldwell Heights,644,657,2015-03-31,-13,ES
3439,Callison,843,910,2015-03-31,-67,ES
3440,Canyon Creek,431,462,2015-03-31,-31,ES
3441,Canyon Vista,1357,1344,2015-03-31,13,MS
3442,Caraway,711,701,2015-03-31,10,ES
3443,Cedar Ridge,2673,2732,2015-03-31,-59,HS
3444,Cedar Valley,1323,1305,2015-03-31,18,MS
3445,Chandler Oaks,551,570,2015-03-31,-19,ES
3446,Chisholm Trail,1062,1019,2015-03-31,43,MS
3447,Deepwood,395,389,2015-03-31,6,ES
3448,Deerpark,921,983,2015-03-31,-62,MS
3449,Double File Trail,666,753,2015-03-31,-87,ES
3450,DAEP,8,7,2015-03-31,1,Other
3451,England,835,805,2015-03-31,30,ES
3452,Fern Bluff,683,719,2015-03-31,-36,ES
3453,Forest Creek,834,860,2015-03-31,-26,ES
3454,Forest North,409,444,2015-03-31,-35,ES
3455,Gattis,779,782,2015-03-31,-3,ES
3456,Great Oaks,740,694,2015-03-31,46,ES
3457,Grisham,668,648,2015-03-31,20,MS
3458,Hernandez,823,848,2015-03-31,-25,MS
3459,Herrington,855,809,2015-03-31,46,ES
3460,Hopewell,972,899,2015-03-31,73,MS
3461,JJAEP,27,26,2015-03-31,1,Other
3462,Jollyville,469,444,2015-03-31,25,ES
3463,Laurel Mountain,790,767,2015-03-31,23,ES
3464,Live Oak,532,570,2015-03-31,-38,ES
3465,McNeil,2477,2556,2015-03-31,-79,HS
3466,Old Town,721,749,2015-03-31,-28,ES
3467,Pond Springs,649,641,2015-03-31,8,ES
3468,Purple Sage,320,343,2015-03-31,-23,ES
3469,Round Rock Opportunity Center,89,46,2015-03-31,43,Other
3470,Ridgeview,1374,1359,2015-03-31,15,MS
3471,Robertson,495,503,2015-03-31,-8,ES
3472,Round Rock,2906,2995,2015-03-31,-89,HS
3473,Sommer,1000,969,2015-03-31,31,ES
3474,Spicewood,807,785,2015-03-31,22,ES
3475,Stony Point,2400,2492,2015-03-31,-92,HS
3476,Success,368,128,2015-03-31,240,HS
3477,Teravista,878,883,2015-03-31,-5,ES
3478,Union Hill,832,877,2015-03-31,-45,ES
3479,Voigt,577,604,2015-03-31,-27,ES
3480,Walsh,1464,1455,2015-03-31,9,MS
3481,Wells Branch,951,1075,2015-03-31,-124,ES
3482,Westwood,2687,2721,2015-03-31,-34,HS
3483,Anderson Mill,485,492,2015-04-07,-7,ES
3484,Berkman,500,548,2015-04-07,-48,ES
3485,Blackland Prairie,856,831,2015-04-07,25,ES
3486,Bluebonnet,598,591,2015-04-07,7,ES
3487,Brushy Creek,784,778,2015-04-07,6,ES
3488,C.D. Fulkes,732,778,2015-04-07,-46,MS
3489,Cactus Ranch,1073,1071,2015-04-07,2,ES
3490,Caldwell Heights,645,657,2015-04-07,-12,ES
3491,Callison,838,910,2015-04-07,-72,ES
3492,Canyon Creek,429,462,2015-04-07,-33,ES
3493,Canyon Vista,1355,1344,2015-04-07,11,MS
3494,Caraway,714,701,2015-04-07,13,ES
3495,Cedar Ridge,2671,2732,2015-04-07,-61,HS
3496,Cedar Valley,1323,1305,2015-04-07,18,MS
3497,Chandler Oaks,548,570,2015-04-07,-22,ES
3498,Chisholm Trail,1061,1019,2015-04-07,42,MS
3499,Deepwood,396,389,2015-04-07,7,ES
3500,Deerpark,925,983,2015-04-07,-58,MS
3501,Double File Trail,666,753,2015-04-07,-87,ES
3502,DAEP,7,7,2015-04-07,0,Other
3503,England,834,805,2015-04-07,29,ES
3504,Fern Bluff,685,719,2015-04-07,-34,ES
3505,Forest Creek,837,860,2015-04-07,-23,ES
3506,Forest North,413,444,2015-04-07,-31,ES
3507,Gattis,778,782,2015-04-07,-4,ES
3508,Great Oaks,743,694,2015-04-07,49,ES
3509,Grisham,664,648,2015-04-07,16,MS
3510,Hernandez,819,848,2015-04-07,-29,MS
3511,Herrington,857,809,2015-04-07,48,ES
3512,Hopewell,971,899,2015-04-07,72,MS
3513,JJAEP,28,26,2015-04-07,2,Other
3514,Jollyville,466,444,2015-04-07,22,ES
3515,Laurel Mountain,792,767,2015-04-07,25,ES
3516,Live Oak,530,570,2015-04-07,-40,ES
3517,McNeil,2481,2556,2015-04-07,-75,HS
3518,Old Town,720,749,2015-04-07,-29,ES
3519,Pond Springs,652,641,2015-04-07,11,ES
3520,Purple Sage,319,343,2015-04-07,-24,ES
3521,Round Rock Opportunity Center,85,46,2015-04-07,39,Other
3522,Ridgeview,1374,1359,2015-04-07,15,MS
3523,Robertson,489,503,2015-04-07,-14,ES
3524,Round Rock,2896,2995,2015-04-07,-99,HS
3525,Sommer,1005,969,2015-04-07,36,ES
3526,Spicewood,809,785,2015-04-07,24,ES
3527,Stony Point,2392,2492,2015-04-07,-100,HS
3528,Success,359,128,2015-04-07,231,HS
3529,Teravista,875,883,2015-04-07,-8,ES
3530,Union Hill,829,877,2015-04-07,-48,ES
3531,Voigt,576,604,2015-04-07,-28,ES
3532,Walsh,1466,1455,2015-04-07,11,MS
3533,Wells Branch,951,1075,2015-04-07,-124,ES
3534,Westwood,2686,2721,2015-04-07,-35,HS
3535,Anderson Mill,486,492,2015-04-14,-6,ES
3536,Berkman,497,548,2015-04-14,-51,ES
3537,Blackland Prairie,856,831,2015-04-14,25,ES
3538,Bluebonnet,600,591,2015-04-14,9,ES
3539,Brushy Creek,784,778,2015-04-14,6,ES
3540,C.D. Fulkes,735,778,2015-04-14,-43,MS
3541,Cactus Ranch,1073,1071,2015-04-14,2,ES
3542,Caldwell Heights,649,657,2015-04-14,-8,ES
3543,Callison,839,910,2015-04-14,-71,ES
3544,Canyon Creek,429,462,2015-04-14,-33,ES
3545,Canyon Vista,1356,1344,2015-04-14,12,MS
3546,Caraway,716,701,2015-04-14,15,ES
3547,Cedar Ridge,2671,2732,2015-04-14,-61,HS
3548,Cedar Valley,1326,1305,2015-04-14,21,MS
3549,Chandler Oaks,548,570,2015-04-14,-22,ES
3550,Chisholm Trail,1065,1019,2015-04-14,46,MS
3551,Deepwood,396,389,2015-04-14,7,ES
3552,Deerpark,927,983,2015-04-14,-56,MS
3553,Double File Trail,665,753,2015-04-14,-88,ES
3554,DAEP,9,7,2015-04-14,2,Other
3555,England,836,805,2015-04-14,31,ES
3556,Fern Bluff,684,719,2015-04-14,-35,ES
3557,Forest Creek,838,860,2015-04-14,-22,ES
3558,Forest North,411,444,2015-04-14,-33,ES
3559,Gattis,779,782,2015-04-14,-3,ES
3560,Great Oaks,743,694,2015-04-14,49,ES
3561,Grisham,661,648,2015-04-14,13,MS
3562,Hernandez,819,848,2015-04-14,-29,MS
3563,Herrington,856,809,2015-04-14,47,ES
3564,Hopewell,974,899,2015-04-14,75,MS
3565,JJAEP,28,26,2015-04-14,2,Other
3566,Jollyville,463,444,2015-04-14,19,ES
3567,Laurel Mountain,792,767,2015-04-14,25,ES
3568,Live Oak,530,570,2015-04-14,-40,ES
3569,McNeil,2479,2556,2015-04-14,-77,HS
3570,Old Town,720,749,2015-04-14,-29,ES
3571,Pond Springs,653,641,2015-04-14,12,ES
3572,Purple Sage,318,343,2015-04-14,-25,ES
3573,Round Rock Opportunity Center,82,46,2015-04-14,36,Other
3574,Ridgeview,1374,1359,2015-04-14,15,MS
3575,Robertson,493,503,2015-04-14,-10,ES
3576,Round Rock,2898,2995,2015-04-14,-97,HS
3577,Sommer,1005,969,2015-04-14,36,ES
3578,Spicewood,810,785,2015-04-14,25,ES
3579,Stony Point,2391,2492,2015-04-14,-101,HS
3580,Success,349,128,2015-04-14,221,HS
3581,Teravista,876,883,2015-04-14,-7,ES
3582,Union Hill,832,877,2015-04-14,-45,ES
3583,Voigt,576,604,2015-04-14,-28,ES
3584,Walsh,1468,1455,2015-04-14,13,MS
3585,Wells Branch,951,1075,2015-04-14,-124,ES
3586,Westwood,2679,2721,2015-04-14,-42,HS
3587,Anderson Mill,485,492,2015-04-21,-7,ES
3588,Berkman,490,548,2015-04-21,-58,ES
3589,Blackland Prairie,858,831,2015-04-21,27,ES
3590,Bluebonnet,598,591,2015-04-21,7,ES
3591,Brushy Creek,787,778,2015-04-21,9,ES
3592,C.D. Fulkes,734,778,2015-04-21,-44,MS
3593,Cactus Ranch,1074,1071,2015-04-21,3,ES
3594,Caldwell Heights,649,657,2015-04-21,-8,ES
3595,Callison,839,910,2015-04-21,-71,ES
3596,Canyon Creek,429,462,2015-04-21,-33,ES
3597,Canyon Vista,1357,1344,2015-04-21,13,MS
3598,Caraway,720,701,2015-04-21,19,ES
3599,Cedar Ridge,2660,2732,2015-04-21,-72,HS
3600,Cedar Valley,1326,1305,2015-04-21,21,MS
3601,Chandler Oaks,548,570,2015-04-21,-22,ES
3602,Chisholm Trail,1064,1019,2015-04-21,45,MS
3603,Deepwood,396,389,2015-04-21,7,ES
3604,Deerpark,924,983,2015-04-21,-59,MS
3605,Double File Trail,662,753,2015-04-21,-91,ES
3606,DAEP,12,7,2015-04-21,5,Other
3607,England,837,805,2015-04-21,32,ES
3608,Fern Bluff,682,719,2015-04-21,-37,ES
3609,Forest Creek,839,860,2015-04-21,-21,ES
3610,Forest North,412,444,2015-04-21,-32,ES
3611,Gattis,780,782,2015-04-21,-2,ES
3612,Great Oaks,742,694,2015-04-21,48,ES
3613,Grisham,661,648,2015-04-21,13,MS
3614,Hernandez,817,848,2015-04-21,-31,MS
3615,Herrington,857,809,2015-04-21,48,ES
3616,Hopewell,974,899,2015-04-21,75,MS
3617,JJAEP,25,26,2015-04-21,-1,Other
3618,Jollyville,467,444,2015-04-21,23,ES
3619,Laurel Mountain,793,767,2015-04-21,26,ES
3620,Live Oak,530,570,2015-04-21,-40,ES
3621,McNeil,2468,2556,2015-04-21,-88,HS
3622,Old Town,720,749,2015-04-21,-29,ES
3623,Pond Springs,656,641,2015-04-21,15,ES
3624,Purple Sage,318,343,2015-04-21,-25,ES
3625,Round Rock Opportunity Center,96,46,2015-04-21,50,Other
3626,Ridgeview,1375,1359,2015-04-21,16,MS
3627,Robertson,492,503,2015-04-21,-11,ES
3628,Round Rock,2891,2995,2015-04-21,-104,HS
3629,Sommer,1006,969,2015-04-21,37,ES
3630,Spicewood,809,785,2015-04-21,24,ES
3631,Stony Point,2382,2492,2015-04-21,-110,HS
3632,Success,347,128,2015-04-21,219,HS
3633,Teravista,876,883,2015-04-21,-7,ES
3634,Union Hill,833,877,2015-04-21,-44,ES
3635,Voigt,576,604,2015-04-21,-28,ES
3636,Walsh,1467,1455,2015-04-21,12,MS
3637,Wells Branch,942,1075,2015-04-21,-133,ES
3638,Westwood,2674,2721,2015-04-21,-47,HS
3639,Anderson Mill,485,492,2015-04-28,-7,ES
3640,Berkman,492,548,2015-04-28,-56,ES
3641,Blackland Prairie,856,831,2015-04-28,25,ES
3642,Bluebonnet,600,591,2015-04-28,9,ES
3643,Brushy Creek,786,778,2015-04-28,8,ES
3644,C.D. Fulkes,736,778,2015-04-28,-42,MS
3645,Cactus Ranch,1071,1071,2015-04-28,0,ES
3646,Caldwell Heights,649,657,2015-04-28,-8,ES
3647,Callison,839,910,2015-04-28,-71,ES
3648,Canyon Creek,429,462,2015-04-28,-33,ES
3649,Canyon Vista,1357,1344,2015-04-28,13,MS
3650,Caraway,718,701,2015-04-28,17,ES
3651,Cedar Ridge,2659,2732,2015-04-28,-73,HS
3652,Cedar Valley,1325,1305,2015-04-28,20,MS
3653,Chandler Oaks,548,570,2015-04-28,-22,ES
3654,Chisholm Trail,1058,1019,2015-04-28,39,MS
3655,Deepwood,395,389,2015-04-28,6,ES
3656,Deerpark,926,983,2015-04-28,-57,MS
3657,Double File Trail,660,753,2015-04-28,-93,ES
3658,DAEP,12,7,2015-04-28,5,Other
3659,England,838,805,2015-04-28,33,ES
3660,Fern Bluff,684,719,2015-04-28,-35,ES
3661,Forest Creek,841,860,2015-04-28,-19,ES
3662,Forest North,410,444,2015-04-28,-34,ES
3663,Gattis,778,782,2015-04-28,-4,ES
3664,Great Oaks,743,694,2015-04-28,49,ES
3665,Grisham,666,648,2015-04-28,18,MS
3666,Hernandez,820,848,2015-04-28,-28,MS
3667,Herrington,857,809,2015-04-28,48,ES
3668,Hopewell,974,899,2015-04-28,75,MS
3669,JJAEP,25,26,2015-04-28,-1,Other
3670,Jollyville,462,444,2015-04-28,18,ES
3671,Laurel Mountain,794,767,2015-04-28,27,ES
3672,Live Oak,526,570,2015-04-28,-44,ES
3673,McNeil,2468,2556,2015-04-28,-88,HS
3674,Old Town,718,749,2015-04-28,-31,ES
3675,Pond Springs,658,641,2015-04-28,17,ES
3676,Purple Sage,318,343,2015-04-28,-25,ES
3677,Round Rock Opportunity Center,98,46,2015-04-28,52,Other
3678,Ridgeview,1376,1359,2015-04-28,17,MS
3679,Robertson,492,503,2015-04-28,-11,ES
3680,Round Rock,2886,2995,2015-04-28,-109,HS
3681,Sommer,1007,969,2015-04-28,38,ES
3682,Spicewood,810,785,2015-04-28,25,ES
3683,Stony Point,2381,2492,2015-04-28,-111,HS
3684,Success,333,128,2015-04-28,205,HS
3685,Teravista,876,883,2015-04-28,-7,ES
3686,Union Hill,828,877,2015-04-28,-49,ES
3687,Voigt,575,604,2015-04-28,-29,ES
3688,Walsh,1467,1455,2015-04-28,12,MS
3689,Wells Branch,940,1075,2015-04-28,-135,ES
3690,Westwood,2670,2721,2015-04-28,-51,HS
3691,Anderson Mill,486,492,2015-05-05,-6,ES
3692,Berkman,492,548,2015-05-05,-56,ES
3693,Blackland Prairie,855,831,2015-05-05,24,ES
3694,Bluebonnet,599,591,2015-05-05,8,ES
3695,Brushy Creek,786,778,2015-05-05,8,ES
3696,C.D. Fulkes,738,778,2015-05-05,-40,MS
3697,Cactus Ranch,1071,1071,2015-05-05,0,ES
3698,Caldwell Heights,646,657,2015-05-05,-11,ES
3699,Callison,840,910,2015-05-05,-70,ES
3700,Canyon Creek,429,462,2015-05-05,-33,ES
3701,Canyon Vista,1354,1344,2015-05-05,10,MS
3702,Caraway,719,701,2015-05-05,18,ES
3703,Cedar Ridge,2651,2732,2015-05-05,-81,HS
3704,Cedar Valley,1326,1305,2015-05-05,21,MS
3705,Chandler Oaks,550,570,2015-05-05,-20,ES
3706,Chisholm Trail,1058,1019,2015-05-05,39,MS
3707,Deepwood,397,389,2015-05-05,8,ES
3708,Deerpark,921,983,2015-05-05,-62,MS
3709,Double File Trail,660,753,2015-05-05,-93,ES
3710,DAEP,12,7,2015-05-05,5,Other
3711,England,839,805,2015-05-05,34,ES
3712,Fern Bluff,689,719,2015-05-05,-30,ES
3713,Forest Creek,840,860,2015-05-05,-20,ES
3714,Forest North,409,444,2015-05-05,-35,ES
3715,Gattis,777,782,2015-05-05,-5,ES
3716,Great Oaks,744,694,2015-05-05,50,ES
3717,Grisham,663,648,2015-05-05,15,MS
3718,Hernandez,818,848,2015-05-05,-30,MS
3719,Herrington,856,809,2015-05-05,47,ES
3720,Hopewell,975,899,2015-05-05,76,MS
3721,JJAEP,23,26,2015-05-05,-3,Other
3722,Jollyville,461,444,2015-05-05,17,ES
3723,Laurel Mountain,796,767,2015-05-05,29,ES
3724,Live Oak,527,570,2015-05-05,-43,ES
3725,McNeil,2464,2556,2015-05-05,-92,HS
3726,Old Town,718,749,2015-05-05,-31,ES
3727,Pond Springs,657,641,2015-05-05,16,ES
3728,Purple Sage,317,343,2015-05-05,-26,ES
3729,Round Rock Opportunity Center,109,46,2015-05-05,63,Other
3730,Ridgeview,1377,1359,2015-05-05,18,MS
3731,Robertson,493,503,2015-05-05,-10,ES
3732,Round Rock,2881,2995,2015-05-05,-114,HS
3733,Sommer,1009,969,2015-05-05,40,ES
3734,Spicewood,810,785,2015-05-05,25,ES
3735,Stony Point,2376,2492,2015-05-05,-116,HS
3736,Success,322,128,2015-05-05,194,HS
3737,Teravista,874,883,2015-05-05,-9,ES
3738,Union Hill,829,877,2015-05-05,-48,ES
3739,Voigt,568,604,2015-05-05,-36,ES
3740,Walsh,1469,1455,2015-05-05,14,MS
3741,Wells Branch,941,1075,2015-05-05,-134,ES
3742,Westwood,2667,2721,2015-05-05,-54,HS
3743,Anderson Mill,487,492,2015-05-12,-5,ES
3744,Berkman,491,548,2015-05-12,-57,ES
3745,Blackland Prairie,855,831,2015-05-12,24,ES
3746,Bluebonnet,599,591,2015-05-12,8,ES
3747,Brushy Creek,787,778,2015-05-12,9,ES
3748,C.D. Fulkes,737,778,2015-05-12,-41,MS
3749,Cactus Ranch,1069,1071,2015-05-12,-2,ES
3750,Caldwell Heights,644,657,2015-05-12,-13,ES
3751,Callison,839,910,2015-05-12,-71,ES
3752,Canyon Creek,430,462,2015-05-12,-32,ES
3753,Canyon Vista,1354,1344,2015-05-12,10,MS
3754,Caraway,719,701,2015-05-12,18,ES
3755,Cedar Ridge,2655,2732,2015-05-12,-77,HS
3756,Cedar Valley,1325,1305,2015-05-12,20,MS
3757,Chandler Oaks,550,570,2015-05-12,-20,ES
3758,Chisholm Trail,1057,1019,2015-05-12,38,MS
3759,Deepwood,397,389,2015-05-12,8,ES
3760,Deerpark,919,983,2015-05-12,-64,MS
3761,Double File Trail,659,753,2015-05-12,-94,ES
3762,DAEP,12,7,2015-05-12,5,Other
3763,England,840,805,2015-05-12,35,ES
3764,Fern Bluff,689,719,2015-05-12,-30,ES
3765,Forest Creek,839,860,2015-05-12,-21,ES
3766,Forest North,409,444,2015-05-12,-35,ES
3767,Gattis,779,782,2015-05-12,-3,ES
3768,Great Oaks,746,694,2015-05-12,52,ES
3769,Grisham,662,648,2015-05-12,14,MS
3770,Hernandez,817,848,2015-05-12,-31,MS
3771,Herrington,851,809,2015-05-12,42,ES
3772,Hopewell,976,899,2015-05-12,77,MS
3773,JJAEP,24,26,2015-05-12,-2,Other
3774,Jollyville,461,444,2015-05-12,17,ES
3775,Laurel Mountain,797,767,2015-05-12,30,ES
3776,Live Oak,528,570,2015-05-12,-42,ES
3777,McNeil,2462,2556,2015-05-12,-94,HS
3778,Old Town,719,749,2015-05-12,-30,ES
3779,Pond Springs,654,641,2015-05-12,13,ES
3780,Purple Sage,318,343,2015-05-12,-25,ES
3781,Round Rock Opportunity Center,114,46,2015-05-12,68,Other
3782,Ridgeview,1376,1359,2015-05-12,17,MS
3783,Robertson,496,503,2015-05-12,-7,ES
3784,Round Rock,2886,2995,2015-05-12,-109,HS
3785,Sommer,1009,969,2015-05-12,40,ES
3786,Spicewood,808,785,2015-05-12,23,ES
3787,Stony Point,2376,2492,2015-05-12,-116,HS
3788,Success,301,128,2015-05-12,173,HS
3789,Teravista,874,883,2015-05-12,-9,ES
3790,Union Hill,830,877,2015-05-12,-47,ES
3791,Voigt,569,604,2015-05-12,-35,ES
3792,Walsh,1468,1455,2015-05-12,13,MS
3793,Wells Branch,943,1075,2015-05-12,-132,ES
3794,Westwood,2663,2721,2015-05-12,-58,HS
3795,Anderson Mill,488,492,2015-05-19,-4,ES
3796,Berkman,494,548,2015-05-19,-54,ES
3797,Blackland Prairie,854,831,2015-05-19,23,ES
3798,Bluebonnet,598,591,2015-05-19,7,ES
3799,Brushy Creek,783,778,2015-05-19,5,ES
3800,C.D. Fulkes,737,778,2015-05-19,-41,MS
3801,Cactus Ranch,1069,1071,2015-05-19,-2,ES
3802,Caldwell Heights,645,657,2015-05-19,-12,ES
3803,Callison,835,910,2015-05-19,-75,ES
3804,Canyon Creek,430,462,2015-05-19,-32,ES
3805,Canyon Vista,1353,1344,2015-05-19,9,MS
3806,Caraway,718,701,2015-05-19,17,ES
3807,Cedar Ridge,2656,2732,2015-05-19,-76,HS
3808,Cedar Valley,1325,1305,2015-05-19,20,MS
3809,Chandler Oaks,550,570,2015-05-19,-20,ES
3810,Chisholm Trail,1057,1019,2015-05-19,38,MS
3811,Deepwood,396,389,2015-05-19,7,ES
3812,Deerpark,919,983,2015-05-19,-64,MS
3813,Double File Trail,663,753,2015-05-19,-90,ES
3814,DAEP,10,7,2015-05-19,3,Other
3815,England,838,805,2015-05-19,33,ES
3816,Fern Bluff,689,719,2015-05-19,-30,ES
3817,Forest Creek,840,860,2015-05-19,-20,ES
3818,Forest North,407,444,2015-05-19,-37,ES
3819,Gattis,779,782,2015-05-19,-3,ES
3820,Great Oaks,744,694,2015-05-19,50,ES
3821,Grisham,662,648,2015-05-19,14,MS
3822,Hernandez,816,848,2015-05-19,-32,MS
3823,Herrington,851,809,2015-05-19,42,ES
3824,Hopewell,974,899,2015-05-19,75,MS
3825,JJAEP,24,26,2015-05-19,-2,Other
3826,Jollyville,461,444,2015-05-19,17,ES
3827,Laurel Mountain,796,767,2015-05-19,29,ES
3828,Live Oak,526,570,2015-05-19,-44,ES
3829,McNeil,2461,2556,2015-05-19,-95,HS
3830,Old Town,718,749,2015-05-19,-31,ES
3831,Pond Springs,654,641,2015-05-19,13,ES
3832,Purple Sage,318,343,2015-05-19,-25,ES
3833,Round Rock Opportunity Center,114,46,2015-05-19,68,Other
3834,Ridgeview,1375,1359,2015-05-19,16,MS
3835,Robertson,498,503,2015-05-19,-5,ES
3836,Round Rock,2887,2995,2015-05-19,-108,HS
3837,Sommer,1009,969,2015-05-19,40,ES
3838,Spicewood,808,785,2015-05-19,23,ES
3839,Stony Point,2376,2492,2015-05-19,-116,HS
3840,Success,278,128,2015-05-19,150,HS
3841,Teravista,877,883,2015-05-19,-6,ES
3842,Union Hill,829,877,2015-05-19,-48,ES
3843,Voigt,569,604,2015-05-19,-35,ES
3844,Walsh,1466,1455,2015-05-19,11,MS
3845,Wells Branch,942,1075,2015-05-19,-133,ES
3846,Westwood,2660,2721,2015-05-19,-61,HS
3847,Anderson Mill,490,492,2015-05-26,-2,ES
3848,Berkman,494,548,2015-05-26,-54,ES
3849,Blackland Prairie,852,831,2015-05-26,21,ES
3850,Bluebonnet,597,591,2015-05-26,6,ES
3851,Brushy Creek,780,778,2015-05-26,2,ES
3852,C.D. Fulkes,736,778,2015-05-26,-42,MS
3853,Cactus Ranch,1070,1071,2015-05-26,-1,ES
3854,Caldwell Heights,646,657,2015-05-26,-11,ES
3855,Callison,829,910,2015-05-26,-81,ES
3856,Canyon Creek,430,462,2015-05-26,-32,ES
3857,Canyon Vista,1352,1344,2015-05-26,8,MS
3858,Caraway,716,701,2015-05-26,15,ES
3859,Cedar Ridge,2654,2732,2015-05-26,-78,HS
3860,Cedar Valley,1325,1305,2015-05-26,20,MS
3861,Chandler Oaks,550,570,2015-05-26,-20,ES
3862,Chisholm Trail,1058,1019,2015-05-26,39,MS
3863,Deepwood,396,389,2015-05-26,7,ES
3864,Deerpark,920,983,2015-05-26,-63,MS
3865,Double File Trail,663,753,2015-05-26,-90,ES
3866,DAEP,13,7,2015-05-26,6,Other
3867,England,837,805,2015-05-26,32,ES
3868,Fern Bluff,689,719,2015-05-26,-30,ES
3869,Forest Creek,840,860,2015-05-26,-20,ES
3870,Forest North,408,444,2015-05-26,-36,ES
3871,Gattis,779,782,2015-05-26,-3,ES
3872,Great Oaks,744,694,2015-05-26,50,ES
3873,Grisham,660,648,2015-05-26,12,MS
3874,Hernandez,816,848,2015-05-26,-32,MS
3875,Herrington,851,809,2015-05-26,42,ES
3876,Hopewell,974,899,2015-05-26,75,MS
3877,JJAEP,23,26,2015-05-26,-3,Other
3878,Jollyville,459,444,2015-05-26,15,ES
3879,Laurel Mountain,798,767,2015-05-26,31,ES
3880,Live Oak,526,570,2015-05-26,-44,ES
3881,McNeil,2462,2556,2015-05-26,-94,HS
3882,Old Town,718,749,2015-05-26,-31,ES
3883,Pond Springs,654,641,2015-05-26,13,ES
3884,Purple Sage,317,343,2015-05-26,-26,ES
3885,Round Rock Opportunity Center,112,46,2015-05-26,66,Other
3886,Ridgeview,1375,1359,2015-05-26,16,MS
3887,Robertson,498,503,2015-05-26,-5,ES
3888,Round Rock,2886,2995,2015-05-26,-109,HS
3889,Sommer,1008,969,2015-05-26,39,ES
3890,Spicewood,806,785,2015-05-26,21,ES
3891,Stony Point,2378,2492,2015-05-26,-114,HS
3892,Success,249,128,2015-05-26,121,HS
3893,Teravista,877,883,2015-05-26,-6,ES
3894,Union Hill,829,877,2015-05-26,-48,ES
3895,Voigt,569,604,2015-05-26,-35,ES
3896,Walsh,1466,1455,2015-05-26,11,MS
3897,Wells Branch,939,1075,2015-05-26,-136,ES
3898,Westwood,2659,2721,2015-05-26,-62,HS
3899,Anderson Mill,481,495,2015-08-25,-14,ES
3900,Berkman,462,506,2015-08-25,-44,ES
3901,Blackland Prairie,788,807,2015-08-25,-19,ES
3902,Bluebonnet,553,567,2015-08-25,-14,ES
3903,Brushy Creek,786,753,2015-08-25,33,ES
3904,C.D. Fulkes,694,732,2015-08-25,-38,MS
3905,Cactus Ranch,1004,1048,2015-08-25,-44,ES
3906,Caldwell Heights,657,660,2015-08-25,-3,ES
3907,Callison,800,866,2015-08-25,-66,ES
3908,Canyon Creek,405,424,2015-08-25,-19,ES
3909,Canyon Vista,1378,1400,2015-08-25,-22,MS
3910,Caraway,710,707,2015-08-25,3,ES
3911,Cedar Ridge,2741,2726,2015-08-25,15,HS
3912,Cedar Valley,1343,1364,2015-08-25,-21,MS
3913,Chandler Oaks,510,542,2015-08-25,-32,ES
3914,Chisholm Trail,1030,1069,2015-08-25,-39,MS
3915,Deepwood,356,404,2015-08-25,-48,ES
3916,Deerpark,875,958,2015-08-25,-83,MS
3917,Double File Trail,565,655,2015-08-25,-90,ES
3918,DAEP,0,5,2015-08-25,-5,Other
3919,England,863,891,2015-08-25,-28,ES
3920,Fern Bluff,643,655,2015-08-25,-12,ES
3921,Forest Creek,813,837,2015-08-25,-24,ES
3922,Forest North,383,411,2015-08-25,-28,ES
3923,Gattis,675,797,2015-08-25,-122,ES
3924,Great Oaks,699,684,2015-08-25,15,ES
3925,Grisham,684,653,2015-08-25,31,MS
3926,Hernandez,767,802,2015-08-25,-35,MS
3927,Herrington,863,916,2015-08-25,-53,ES
3928,Hopewell,972,1054,2015-08-25,-82,MS
3929,JJAEP,22,29,2015-08-25,-7,Other
3930,Jollyville,440,481,2015-08-25,-41,ES
3931,Laurel Mountain,786,780,2015-08-25,6,ES
3932,Live Oak,563,539,2015-08-25,24,ES
3933,McNeil,2578,2638,2015-08-25,-60,HS
3934,Old Town,664,694,2015-08-25,-30,ES
3935,Pond Springs,612,658,2015-08-25,-46,ES
3936,Purple Sage,320,341,2015-08-25,-21,ES
3937,Round Rock Opportunity Center,30,52,2015-08-25,-22,Other
3938,Ridgeview,1373,1375,2015-08-25,-2,MS
3939,Robertson,480,512,2015-08-25,-32,ES
3940,Round Rock,3114,3175,2015-08-25,-61,HS
3941,Sommer,1045,1016,2015-08-25,29,ES
3942,Spicewood,800,807,2015-08-25,-7,ES
3943,Stony Point,2534,2570,2015-08-25,-36,HS
3944,Success,370,307,2015-08-25,63,HS
3945,Teravista,845,923,2015-08-25,-78,ES
3946,Union Hill,798,883,2015-08-25,-85,ES
3947,Voigt,512,566,2015-08-25,-54,ES
3948,Walsh,1601,1532,2015-08-25,69,MS
3949,Wells Branch,902,939,2015-08-25,-37,ES
3950,Westwood,2672,2749,2015-08-25,-77,HS
3951,Anderson Mill,502,495,2015-09-01,7,ES
3952,Berkman,495,506,2015-09-01,-11,ES
3953,Blackland Prairie,796,807,2015-09-01,-11,ES
3954,Bluebonnet,567,567,2015-09-01,0,ES
3955,Brushy Creek,802,753,2015-09-01,49,ES
3956,C.D. Fulkes,714,732,2015-09-01,-18,MS
3957,Cactus Ranch,1016,1048,2015-09-01,-32,ES
3958,Caldwell Heights,679,660,2015-09-01,19,ES
3959,Callison,817,866,2015-09-01,-49,ES
3960,Canyon Creek,414,424,2015-09-01,-10,ES
3961,Canyon Vista,1395,1400,2015-09-01,-5,MS
3962,Caraway,719,707,2015-09-01,12,ES
3963,Cedar Ridge,2779,2726,2015-09-01,53,HS
3964,Cedar Valley,1365,1364,2015-09-01,1,MS
3965,Chandler Oaks,523,542,2015-09-01,-19,ES
3966,Chisholm Trail,1035,1069,2015-09-01,-34,MS
3967,Deepwood,363,404,2015-09-01,-41,ES
3968,Deerpark,903,958,2015-09-01,-55,MS
3969,Double File Trail,576,655,2015-09-01,-79,ES
3970,DAEP,0,5,2015-09-01,-5,Other
3971,England,888,891,2015-09-01,-3,ES
3972,Fern Bluff,650,655,2015-09-01,-5,ES
3973,Forest Creek,823,837,2015-09-01,-14,ES
3974,Forest North,390,411,2015-09-01,-21,ES
3975,Gattis,696,797,2015-09-01,-101,ES
3976,Great Oaks,708,684,2015-09-01,24,ES
3977,Grisham,695,653,2015-09-01,42,MS
3978,Hernandez,794,802,2015-09-01,-8,MS
3979,Herrington,879,916,2015-09-01,-37,ES
3980,Hopewell,993,1054,2015-09-01,-61,MS
3981,JJAEP,23,29,2015-09-01,-6,Other
3982,Jollyville,451,481,2015-09-01,-30,ES
3983,Laurel Mountain,794,780,2015-09-01,14,ES
3984,Live Oak,576,539,2015-09-01,37,ES
3985,McNeil,2638,2638,2015-09-01,0,HS
3986,Old Town,672,694,2015-09-01,-22,ES
3987,Pond Springs,621,658,2015-09-01,-37,ES
3988,Purple Sage,330,341,2015-09-01,-11,ES
3989,Round Rock Opportunity Center,33,52,2015-09-01,-19,Other
3990,Ridgeview,1384,1375,2015-09-01,9,MS
3991,Robertson,488,512,2015-09-01,-24,ES
3992,Round Rock,3144,3175,2015-09-01,-31,HS
3993,Sommer,1055,1016,2015-09-01,39,ES
3994,Spicewood,807,807,2015-09-01,0,ES
3995,Stony Point,2602,2570,2015-09-01,32,HS
3996,Success,340,307,2015-09-01,33,HS
3997,Teravista,862,923,2015-09-01,-61,ES
3998,Union Hill,813,883,2015-09-01,-70,ES
3999,Voigt,526,566,2015-09-01,-40,ES
4000,Walsh,1607,1532,2015-09-01,75,MS
4001,Wells Branch,939,939,2015-09-01,0,ES
4002,Westwood,2709,2749,2015-09-01,-40,HS
4003,Anderson Mill,505,495,2015-09-08,10,ES
4004,Berkman,497,506,2015-09-08,-9,ES
4005,Blackland Prairie,799,807,2015-09-08,-8,ES
4006,Bluebonnet,569,567,2015-09-08,2,ES
4007,Brushy Creek,805,753,2015-09-08,52,ES
4008,C.D. Fulkes,714,732,2015-09-08,-18,MS
4009,Cactus Ranch,1018,1048,2015-09-08,-30,ES
4010,Caldwell Heights,676,660,2015-09-08,16,ES
4011,Callison,818,866,2015-09-08,-48,ES
4012,Canyon Creek,416,424,2015-09-08,-8,ES
4013,Canyon Vista,1399,1400,2015-09-08,-1,MS
4014,Caraway,721,707,2015-09-08,14,ES
4015,Cedar Ridge,2777,2726,2015-09-08,51,HS
4016,Cedar Valley,1369,1364,2015-09-08,5,MS
4017,Chandler Oaks,523,542,2015-09-08,-19,ES
4018,Chisholm Trail,1041,1069,2015-09-08,-28,MS
4019,Deepwood,370,404,2015-09-08,-34,ES
4020,Deerpark,904,958,2015-09-08,-54,MS
4021,Double File Trail,578,655,2015-09-08,-77,ES
4022,DAEP,0,5,2015-09-08,-5,Other
4023,England,895,891,2015-09-08,4,ES
4024,Fern Bluff,653,655,2015-09-08,-2,ES
4025,Forest Creek,825,837,2015-09-08,-12,ES
4026,Forest North,396,411,2015-09-08,-15,ES
4027,Gattis,715,797,2015-09-08,-82,ES
4028,Great Oaks,709,684,2015-09-08,25,ES
4029,Grisham,695,653,2015-09-08,42,MS
4030,Hernandez,798,802,2015-09-08,-4,MS
4031,Herrington,879,916,2015-09-08,-37,ES
4032,Hopewell,994,1054,2015-09-08,-60,MS
4033,JJAEP,26,29,2015-09-08,-3,Other
4034,Jollyville,455,481,2015-09-08,-26,ES
4035,Laurel Mountain,797,780,2015-09-08,17,ES
4036,Live Oak,577,539,2015-09-08,38,ES
4037,McNeil,2643,2638,2015-09-08,5,HS
4038,Old Town,669,694,2015-09-08,-25,ES
4039,Pond Springs,619,658,2015-09-08,-39,ES
4040,Purple Sage,329,341,2015-09-08,-12,ES
4041,Round Rock Opportunity Center,40,52,2015-09-08,-12,Other
4042,Ridgeview,1386,1375,2015-09-08,11,MS
4043,Robertson,485,512,2015-09-08,-27,ES
4044,Round Rock,3143,3175,2015-09-08,-32,HS
4045,Sommer,1063,1016,2015-09-08,47,ES
4046,Spicewood,806,807,2015-09-08,-1,ES
4047,Stony Point,2604,2570,2015-09-08,34,HS
4048,Success,337,307,2015-09-08,30,HS
4049,Teravista,862,923,2015-09-08,-61,ES
4050,Union Hill,811,883,2015-09-08,-72,ES
4051,Voigt,528,566,2015-09-08,-38,ES
4052,Walsh,1608,1532,2015-09-08,76,MS
4053,Wells Branch,938,939,2015-09-08,-1,ES
4054,Westwood,2710,2749,2015-09-08,-39,HS
4055,Anderson Mill,511,495,2015-09-15,16,ES
4056,Berkman,501,506,2015-09-15,-5,ES
4057,Blackland Prairie,803,807,2015-09-15,-4,ES
4058,Bluebonnet,568,567,2015-09-15,1,ES
4059,Brushy Creek,807,753,2015-09-15,54,ES
4060,C.D. Fulkes,717,732,2015-09-15,-15,MS
4061,Cactus Ranch,1025,1048,2015-09-15,-23,ES
4062,Caldwell Heights,679,660,2015-09-15,19,ES
4063,Callison,818,866,2015-09-15,-48,ES
4064,Canyon Creek,417,424,2015-09-15,-7,ES
4065,Canyon Vista,1400,1400,2015-09-15,0,MS
4066,Caraway,722,707,2015-09-15,15,ES
4067,Cedar Ridge,2774,2726,2015-09-15,48,HS
4068,Cedar Valley,1370,1364,2015-09-15,6,MS
4069,Chandler Oaks,524,542,2015-09-15,-18,ES
4070,Chisholm Trail,1039,1069,2015-09-15,-30,MS
4071,Deepwood,369,404,2015-09-15,-35,ES
4072,Deerpark,910,958,2015-09-15,-48,MS
4073,Double File Trail,589,655,2015-09-15,-66,ES
4074,DAEP,0,5,2015-09-15,-5,Other
4075,England,894,891,2015-09-15,3,ES
4076,Fern Bluff,653,655,2015-09-15,-2,ES
4077,Forest Creek,822,837,2015-09-15,-15,ES
4078,Forest North,396,411,2015-09-15,-15,ES
4079,Gattis,718,797,2015-09-15,-79,ES
4080,Great Oaks,710,684,2015-09-15,26,ES
4081,Grisham,694,653,2015-09-15,41,MS
4082,Hernandez,807,802,2015-09-15,5,MS
4083,Herrington,882,916,2015-09-15,-34,ES
4084,Hopewell,996,1054,2015-09-15,-58,MS
4085,JJAEP,28,29,2015-09-15,-1,Other
4086,Jollyville,460,481,2015-09-15,-21,ES
4087,Laurel Mountain,798,780,2015-09-15,18,ES
4088,Live Oak,580,539,2015-09-15,41,ES
4089,McNeil,2645,2638,2015-09-15,7,HS
4090,Old Town,673,694,2015-09-15,-21,ES
4091,Pond Springs,621,658,2015-09-15,-37,ES
4092,Purple Sage,327,341,2015-09-15,-14,ES
4093,Round Rock Opportunity Center,37,52,2015-09-15,-15,Other
4094,Ridgeview,1383,1375,2015-09-15,8,MS
4095,Robertson,482,512,2015-09-15,-30,ES
4096,Round Rock,3147,3175,2015-09-15,-28,HS
4097,Sommer,1064,1016,2015-09-15,48,ES
4098,Spicewood,806,807,2015-09-15,-1,ES
4099,Stony Point,2607,2570,2015-09-15,37,HS
4100,Success,333,307,2015-09-15,26,HS
4101,Teravista,861,923,2015-09-15,-62,ES
4102,Union Hill,810,883,2015-09-15,-73,ES
4103,Voigt,528,566,2015-09-15,-38,ES
4104,Walsh,1606,1532,2015-09-15,74,MS
4105,Wells Branch,947,939,2015-09-15,8,ES
4106,Westwood,2710,2749,2015-09-15,-39,HS
4107,Anderson Mill,514,495,2015-09-22,19,ES
4108,Berkman,504,506,2015-09-22,-2,ES
4109,Blackland Prairie,803,807,2015-09-22,-4,ES
4110,Bluebonnet,567,567,2015-09-22,0,ES
4111,Brushy Creek,807,753,2015-09-22,54,ES
4112,C.D. Fulkes,716,732,2015-09-22,-16,MS
4113,Cactus Ranch,1025,1048,2015-09-22,-23,ES
4114,Caldwell Heights,683,660,2015-09-22,23,ES
4115,Callison,820,866,2015-09-22,-46,ES
4116,Canyon Creek,417,424,2015-09-22,-7,ES
4117,Canyon Vista,1401,1400,2015-09-22,1,MS
4118,Caraway,729,707,2015-09-22,22,ES
4119,Cedar Ridge,2769,2726,2015-09-22,43,HS
4120,Cedar Valley,1369,1364,2015-09-22,5,MS
4121,Chandler Oaks,524,542,2015-09-22,-18,ES
4122,Chisholm Trail,1039,1069,2015-09-22,-30,MS
4123,Deepwood,369,404,2015-09-22,-35,ES
4124,Deerpark,910,958,2015-09-22,-48,MS
4125,Double File Trail,588,655,2015-09-22,-67,ES
4126,DAEP,0,5,2015-09-22,-5,Other
4127,England,897,891,2015-09-22,6,ES
4128,Fern Bluff,653,655,2015-09-22,-2,ES
4129,Forest Creek,820,837,2015-09-22,-17,ES
4130,Forest North,396,411,2015-09-22,-15,ES
4131,Gattis,717,797,2015-09-22,-80,ES
4132,Great Oaks,711,684,2015-09-22,27,ES
4133,Grisham,696,653,2015-09-22,43,MS
4134,Hernandez,809,802,2015-09-22,7,MS
4135,Herrington,884,916,2015-09-22,-32,ES
4136,Hopewell,998,1054,2015-09-22,-56,MS
4137,JJAEP,27,29,2015-09-22,-2,Other
4138,Jollyville,461,481,2015-09-22,-20,ES
4139,Laurel Mountain,798,780,2015-09-22,18,ES
4140,Live Oak,580,539,2015-09-22,41,ES
4141,McNeil,2638,2638,2015-09-22,0,HS
4142,Old Town,674,694,2015-09-22,-20,ES
4143,Pond Springs,621,658,2015-09-22,-37,ES
4144,Purple Sage,327,341,2015-09-22,-14,ES
4145,Round Rock Opportunity Center,49,52,2015-09-22,-3,Other
4146,Ridgeview,1383,1375,2015-09-22,8,MS
4147,Robertson,483,512,2015-09-22,-29,ES
4148,Round Rock,3148,3175,2015-09-22,-27,HS
4149,Sommer,1062,1016,2015-09-22,46,ES
4150,Spicewood,807,807,2015-09-22,0,ES
4151,Stony Point,2600,2570,2015-09-22,30,HS
4152,Success,350,307,2015-09-22,43,HS
4153,Teravista,862,923,2015-09-22,-61,ES
4154,Union Hill,813,883,2015-09-22,-70,ES
4155,Voigt,531,566,2015-09-22,-35,ES
4156,Walsh,1607,1532,2015-09-22,75,MS
4157,Wells Branch,946,939,2015-09-22,7,ES
4158,Westwood,2712,2749,2015-09-22,-37,HS
4159,Anderson Mill,511,495,2015-09-29,16,ES
4160,Berkman,503,506,2015-09-29,-3,ES
4161,Blackland Prairie,803,807,2015-09-29,-4,ES
4162,Bluebonnet,568,567,2015-09-29,1,ES
4163,Brushy Creek,806,753,2015-09-29,53,ES
4164,C.D. Fulkes,712,732,2015-09-29,-20,MS
4165,Cactus Ranch,1028,1048,2015-09-29,-20,ES
4166,Caldwell Heights,688,660,2015-09-29,28,ES
4167,Callison,818,866,2015-09-29,-48,ES
4168,Canyon Creek,416,424,2015-09-29,-8,ES
4169,Canyon Vista,1399,1400,2015-09-29,-1,MS
4170,Caraway,728,707,2015-09-29,21,ES
4171,Cedar Ridge,2769,2726,2015-09-29,43,HS
4172,Cedar Valley,1370,1364,2015-09-29,6,MS
4173,Chandler Oaks,525,542,2015-09-29,-17,ES
4174,Chisholm Trail,1039,1069,2015-09-29,-30,MS
4175,Deepwood,369,404,2015-09-29,-35,ES
4176,Deerpark,906,958,2015-09-29,-52,MS
4177,Double File Trail,588,655,2015-09-29,-67,ES
4178,DAEP,0,5,2015-09-29,-5,Other
4179,England,898,891,2015-09-29,7,ES
4180,Fern Bluff,652,655,2015-09-29,-3,ES
4181,Forest Creek,820,837,2015-09-29,-17,ES
4182,Forest North,398,411,2015-09-29,-13,ES
4183,Gattis,722,797,2015-09-29,-75,ES
4184,Great Oaks,715,684,2015-09-29,31,ES
4185,Grisham,694,653,2015-09-29,41,MS
4186,Hernandez,810,802,2015-09-29,8,MS
4187,Herrington,886,916,2015-09-29,-30,ES
4188,Hopewell,992,1054,2015-09-29,-62,MS
4189,JJAEP,27,29,2015-09-29,-2,Other
4190,Jollyville,460,481,2015-09-29,-21,ES
4191,Laurel Mountain,801,780,2015-09-29,21,ES
4192,Live Oak,579,539,2015-09-29,40,ES
4193,McNeil,2638,2638,2015-09-29,0,HS
4194,Old Town,675,694,2015-09-29,-19,ES
4195,Pond Springs,625,658,2015-09-29,-33,ES
4196,Purple Sage,332,341,2015-09-29,-9,ES
4197,Round Rock Opportunity Center,49,52,2015-09-29,-3,Other
4198,Ridgeview,1385,1375,2015-09-29,10,MS
4199,Robertson,487,512,2015-09-29,-25,ES
4200,Round Rock,3148,3175,2015-09-29,-27,HS
4201,Sommer,1062,1016,2015-09-29,46,ES
4202,Spicewood,809,807,2015-09-29,2,ES
4203,Stony Point,2600,2570,2015-09-29,30,HS
4204,Success,350,307,2015-09-29,43,HS
4205,Teravista,860,923,2015-09-29,-63,ES
4206,Union Hill,812,883,2015-09-29,-71,ES
4207,Voigt,534,566,2015-09-29,-32,ES
4208,Walsh,1607,1532,2015-09-29,75,MS
4209,Wells Branch,947,939,2015-09-29,8,ES
4210,Westwood,2712,2749,2015-09-29,-37,HS
4211,Anderson Mill,519,495,2015-10-06,24,ES
4212,Berkman,504,506,2015-10-06,-2,ES
4213,Blackland Prairie,804,807,2015-10-06,-3,ES
4214,Bluebonnet,568,567,2015-10-06,1,ES
4215,Brushy Creek,803,753,2015-10-06,50,ES
4216,C.D. Fulkes,713,732,2015-10-06,-19,MS
4217,Cactus Ranch,1033,1048,2015-10-06,-15,ES
4218,Caldwell Heights,687,660,2015-10-06,27,ES
4219,Callison,826,866,2015-10-06,-40,ES
4220,Canyon Creek,415,424,2015-10-06,-9,ES
4221,Canyon Vista,1400,1400,2015-10-06,0,MS
4222,Caraway,732,707,2015-10-06,25,ES
4223,Cedar Ridge,2755,2726,2015-10-06,29,HS
4224,Cedar Valley,1365,1364,2015-10-06,1,MS
4225,Chandler Oaks,523,542,2015-10-06,-19,ES
4226,Chisholm Trail,1041,1069,2015-10-06,-28,MS
4227,Deepwood,366,404,2015-10-06,-38,ES
4228,Deerpark,906,958,2015-10-06,-52,MS
4229,Double File Trail,590,655,2015-10-06,-65,ES
4230,DAEP,2,5,2015-10-06,-3,Other
4231,England,899,891,2015-10-06,8,ES
4232,Fern Bluff,653,655,2015-10-06,-2,ES
4233,Forest Creek,818,837,2015-10-06,-19,ES
4234,Forest North,397,411,2015-10-06,-14,ES
4235,Gattis,725,797,2015-10-06,-72,ES
4236,Great Oaks,718,684,2015-10-06,34,ES
4237,Grisham,697,653,2015-10-06,44,MS
4238,Hernandez,808,802,2015-10-06,6,MS
4239,Herrington,883,916,2015-10-06,-33,ES
4240,Hopewell,991,1054,2015-10-06,-63,MS
4241,JJAEP,25,29,2015-10-06,-4,Other
4242,Jollyville,460,481,2015-10-06,-21,ES
4243,Laurel Mountain,800,780,2015-10-06,20,ES
4244,Live Oak,581,539,2015-10-06,42,ES
4245,McNeil,2634,2638,2015-10-06,-4,HS
4246,Old Town,678,694,2015-10-06,-16,ES
4247,Pond Springs,624,658,2015-10-06,-34,ES
4248,Purple Sage,330,341,2015-10-06,-11,ES
4249,Round Rock Opportunity Center,63,52,2015-10-06,11,Other
4250,Ridgeview,1383,1375,2015-10-06,8,MS
4251,Robertson,490,512,2015-10-06,-22,ES
4252,Round Rock,3140,3175,2015-10-06,-35,HS
4253,Sommer,1063,1016,2015-10-06,47,ES
4254,Spicewood,809,807,2015-10-06,2,ES
4255,Stony Point,2603,2570,2015-10-06,33,HS
4256,Success,341,307,2015-10-06,34,HS
4257,Teravista,865,923,2015-10-06,-58,ES
4258,Union Hill,816,883,2015-10-06,-67,ES
4259,Voigt,532,566,2015-10-06,-34,ES
4260,Walsh,1606,1532,2015-10-06,74,MS
4261,Wells Branch,951,939,2015-10-06,12,ES
4262,Westwood,2708,2749,2015-10-06,-41,HS
4263,Anderson Mill,516,495,2015-10-13,21,ES
4264,Berkman,504,506,2015-10-13,-2,ES
4265,Blackland Prairie,804,807,2015-10-13,-3,ES
4266,Bluebonnet,569,567,2015-10-13,2,ES
4267,Brushy Creek,803,753,2015-10-13,50,ES
4268,C.D. Fulkes,712,732,2015-10-13,-20,MS
4269,Cactus Ranch,1032,1048,2015-10-13,-16,ES
4270,Caldwell Heights,689,660,2015-10-13,29,ES
4271,Callison,828,866,2015-10-13,-38,ES
4272,Canyon Creek,415,424,2015-10-13,-9,ES
4273,Canyon Vista,1403,1400,2015-10-13,3,MS
4274,Caraway,736,707,2015-10-13,29,ES
4275,Cedar Ridge,2752,2726,2015-10-13,26,HS
4276,Cedar Valley,1364,1364,2015-10-13,0,MS
4277,Chandler Oaks,523,542,2015-10-13,-19,ES
4278,Chisholm Trail,1041,1069,2015-10-13,-28,MS
4279,Deepwood,364,404,2015-10-13,-40,ES
4280,Deerpark,904,958,2015-10-13,-54,MS
4281,Double File Trail,591,655,2015-10-13,-64,ES
4282,DAEP,2,5,2015-10-13,-3,Other
4283,England,897,891,2015-10-13,6,ES
4284,Fern Bluff,655,655,2015-10-13,0,ES
4285,Forest Creek,817,837,2015-10-13,-20,ES
4286,Forest North,398,411,2015-10-13,-13,ES
4287,Gattis,726,797,2015-10-13,-71,ES
4288,Great Oaks,716,684,2015-10-13,32,ES
4289,Grisham,697,653,2015-10-13,44,MS
4290,Hernandez,812,802,2015-10-13,10,MS
4291,Herrington,885,916,2015-10-13,-31,ES
4292,Hopewell,991,1054,2015-10-13,-63,MS
4293,JJAEP,24,29,2015-10-13,-5,Other
4294,Jollyville,460,481,2015-10-13,-21,ES
4295,Laurel Mountain,800,780,2015-10-13,20,ES
4296,Live Oak,578,539,2015-10-13,39,ES
4297,McNeil,2633,2638,2015-10-13,-5,HS
4298,Old Town,676,694,2015-10-13,-18,ES
4299,Pond Springs,630,658,2015-10-13,-28,ES
4300,Purple Sage,331,341,2015-10-13,-10,ES
4301,Round Rock Opportunity Center,60,52,2015-10-13,8,Other
4302,Ridgeview,1384,1375,2015-10-13,9,MS
4303,Robertson,491,512,2015-10-13,-21,ES
4304,Round Rock,3138,3175,2015-10-13,-37,HS
4305,Sommer,1063,1016,2015-10-13,47,ES
4306,Spicewood,809,807,2015-10-13,2,ES
4307,Stony Point,2607,2570,2015-10-13,37,HS
4308,Success,350,307,2015-10-13,43,HS
4309,Teravista,865,923,2015-10-13,-58,ES
4310,Union Hill,815,883,2015-10-13,-68,ES
4311,Voigt,529,566,2015-10-13,-37,ES
4312,Walsh,1606,1532,2015-10-13,74,MS
4313,Wells Branch,948,939,2015-10-13,9,ES
4314,Westwood,2708,2749,2015-10-13,-41,HS
4315,Anderson Mill,520,495,2015-10-20,25,ES
4316,Berkman,504,506,2015-10-20,-2,ES
4317,Blackland Prairie,807,807,2015-10-20,0,ES
4318,Bluebonnet,574,567,2015-10-20,7,ES
4319,Brushy Creek,802,753,2015-10-20,49,ES
4320,C.D. Fulkes,710,732,2015-10-20,-22,MS
4321,Cactus Ranch,1030,1048,2015-10-20,-18,ES
4322,Caldwell Heights,690,660,2015-10-20,30,ES
4323,Callison,831,866,2015-10-20,-35,ES
4324,Canyon Creek,417,424,2015-10-20,-7,ES
4325,Canyon Vista,1404,1400,2015-10-20,4,MS
4326,Caraway,738,707,2015-10-20,31,ES
4327,Cedar Ridge,2754,2726,2015-10-20,28,HS
4328,Cedar Valley,1363,1364,2015-10-20,-1,MS
4329,Chandler Oaks,523,542,2015-10-20,-19,ES
4330,Chisholm Trail,1045,1069,2015-10-20,-24,MS
4331,Deepwood,366,404,2015-10-20,-38,ES
4332,Deerpark,900,958,2015-10-20,-58,MS
4333,Double File Trail,593,655,2015-10-20,-62,ES
4334,DAEP,3,5,2015-10-20,-2,Other
4335,England,899,891,2015-10-20,8,ES
4336,Fern Bluff,655,655,2015-10-20,0,ES
4337,Forest Creek,818,837,2015-10-20,-19,ES
4338,Forest North,394,411,2015-10-20,-17,ES
4339,Gattis,725,797,2015-10-20,-72,ES
4340,Great Oaks,712,684,2015-10-20,28,ES
4341,Grisham,702,653,2015-10-20,49,MS
4342,Hernandez,814,802,2015-10-20,12,MS
4343,Herrington,884,916,2015-10-20,-32,ES
4344,Hopewell,993,1054,2015-10-20,-61,MS
4345,JJAEP,23,29,2015-10-20,-6,Other
4346,Jollyville,461,481,2015-10-20,-20,ES
4347,Laurel Mountain,800,780,2015-10-20,20,ES
4348,Live Oak,577,539,2015-10-20,38,ES
4349,McNeil,2630,2638,2015-10-20,-8,HS
4350,Old Town,673,694,2015-10-20,-21,ES
4351,Pond Springs,633,658,2015-10-20,-25,ES
4352,Purple Sage,331,341,2015-10-20,-10,ES
4353,Round Rock Opportunity Center,54,52,2015-10-20,2,Other
4354,Ridgeview,1382,1375,2015-10-20,7,MS
4355,Robertson,487,512,2015-10-20,-25,ES
4356,Round Rock,3138,3175,2015-10-20,-37,HS
4357,Sommer,1066,1016,2015-10-20,50,ES
4358,Spicewood,809,807,2015-10-20,2,ES
4359,Stony Point,2601,2570,2015-10-20,31,HS
4360,Success,349,307,2015-10-20,42,HS
4361,Teravista,865,923,2015-10-20,-58,ES
4362,Union Hill,816,883,2015-10-20,-67,ES
4363,Voigt,530,566,2015-10-20,-36,ES
4364,Walsh,1605,1532,2015-10-20,73,MS
4365,Wells Branch,952,939,2015-10-20,13,ES
4366,Westwood,2714,2749,2015-10-20,-35,HS
4367,Anderson Mill,518,495,2015-10-27,23,ES
4368,Berkman,504,506,2015-10-27,-2,ES
4369,Blackland Prairie,807,807,2015-10-27,0,ES
4370,Bluebonnet,576,567,2015-10-27,9,ES
4371,Brushy Creek,798,753,2015-10-27,45,ES
4372,C.D. Fulkes,710,732,2015-10-27,-22,MS
4373,Cactus Ranch,1029,1048,2015-10-27,-19,ES
4374,Caldwell Heights,694,660,2015-10-27,34,ES
4375,Callison,835,866,2015-10-27,-31,ES
4376,Canyon Creek,417,424,2015-10-27,-7,ES
4377,Canyon Vista,1395,1400,2015-10-27,-5,MS
4378,Caraway,739,707,2015-10-27,32,ES
4379,Cedar Ridge,2751,2726,2015-10-27,25,HS
4380,Cedar Valley,1366,1364,2015-10-27,2,MS
4381,Chandler Oaks,520,542,2015-10-27,-22,ES
4382,Chisholm Trail,1044,1069,2015-10-27,-25,MS
4383,Deepwood,369,404,2015-10-27,-35,ES
4384,Deerpark,900,958,2015-10-27,-58,MS
4385,Double File Trail,595,655,2015-10-27,-60,ES
4386,DAEP,4,5,2015-10-27,-1,Other
4387,England,901,891,2015-10-27,10,ES
4388,Fern Bluff,655,655,2015-10-27,0,ES
4389,Forest Creek,816,837,2015-10-27,-21,ES
4390,Forest North,395,411,2015-10-27,-16,ES
4391,Gattis,729,797,2015-10-27,-68,ES
4392,Great Oaks,714,684,2015-10-27,30,ES
4393,Grisham,698,653,2015-10-27,45,MS
4394,Hernandez,815,802,2015-10-27,13,MS
4395,Herrington,887,916,2015-10-27,-29,ES
4396,Hopewell,993,1054,2015-10-27,-61,MS
4397,JJAEP,22,29,2015-10-27,-7,Other
4398,Jollyville,463,481,2015-10-27,-18,ES
4399,Laurel Mountain,800,780,2015-10-27,20,ES
4400,Live Oak,573,539,2015-10-27,34,ES
4401,McNeil,2629,2638,2015-10-27,-9,HS
4402,Old Town,668,694,2015-10-27,-26,ES
4403,Pond Springs,634,658,2015-10-27,-24,ES
4404,Purple Sage,331,341,2015-10-27,-10,ES
4405,Round Rock Opportunity Center,57,52,2015-10-27,5,Other
4406,Ridgeview,1379,1375,2015-10-27,4,MS
4407,Robertson,488,512,2015-10-27,-24,ES
4408,Round Rock,3134,3175,2015-10-27,-41,HS
4409,Sommer,1066,1016,2015-10-27,50,ES
4410,Spicewood,808,807,2015-10-27,1,ES
4411,Stony Point,2600,2570,2015-10-27,30,HS
4412,Success,358,307,2015-10-27,51,HS
4413,Teravista,868,923,2015-10-27,-55,ES
4414,Union Hill,813,883,2015-10-27,-70,ES
4415,Voigt,536,566,2015-10-27,-30,ES
4416,Walsh,1605,1532,2015-10-27,73,MS
4417,Wells Branch,950,939,2015-10-27,11,ES
4418,Westwood,2708,2749,2015-10-27,-41,HS
4419,Anderson Mill,517,495,2015-11-03,22,ES
4420,Berkman,505,506,2015-11-03,-1,ES
4421,Blackland Prairie,806,807,2015-11-03,-1,ES
4422,Bluebonnet,572,567,2015-11-03,5,ES
4423,Brushy Creek,798,753,2015-11-03,45,ES
4424,C.D. Fulkes,707,732,2015-11-03,-25,MS
4425,Cactus Ranch,1026,1048,2015-11-03,-22,ES
4426,Caldwell Heights,699,660,2015-11-03,39,ES
4427,Callison,840,866,2015-11-03,-26,ES
4428,Canyon Creek,417,424,2015-11-03,-7,ES
4429,Canyon Vista,1397,1400,2015-11-03,-3,MS
4430,Caraway,728,707,2015-11-03,21,ES
4431,Cedar Ridge,2749,2726,2015-11-03,23,HS
4432,Cedar Valley,1366,1364,2015-11-03,2,MS
4433,Chandler Oaks,520,542,2015-11-03,-22,ES
4434,Chisholm Trail,1045,1069,2015-11-03,-24,MS
4435,Deepwood,368,404,2015-11-03,-36,ES
4436,Deerpark,901,958,2015-11-03,-57,MS
4437,Double File Trail,599,655,2015-11-03,-56,ES
4438,DAEP,5,5,2015-11-03,0,Other
4439,England,898,891,2015-11-03,7,ES
4440,Fern Bluff,655,655,2015-11-03,0,ES
4441,Forest Creek,813,837,2015-11-03,-24,ES
4442,Forest North,396,411,2015-11-03,-15,ES
4443,Gattis,741,797,2015-11-03,-56,ES
4444,Great Oaks,719,684,2015-11-03,35,ES
4445,Grisham,698,653,2015-11-03,45,MS
4446,Hernandez,818,802,2015-11-03,16,MS
4447,Herrington,888,916,2015-11-03,-28,ES
4448,Hopewell,993,1054,2015-11-03,-61,MS
4449,JJAEP,22,29,2015-11-03,-7,Other
4450,Jollyville,464,481,2015-11-03,-17,ES
4451,Laurel Mountain,801,780,2015-11-03,21,ES
4452,Live Oak,571,539,2015-11-03,32,ES
4453,McNeil,2628,2638,2015-11-03,-10,HS
4454,Old Town,669,694,2015-11-03,-25,ES
4455,Pond Springs,634,658,2015-11-03,-24,ES
4456,Purple Sage,330,341,2015-11-03,-11,ES
4457,Round Rock Opportunity Center,67,52,2015-11-03,15,Other
4458,Ridgeview,1374,1375,2015-11-03,-1,MS
4459,Robertson,490,512,2015-11-03,-22,ES
4460,Round Rock,3130,3175,2015-11-03,-45,HS
4461,Sommer,1070,1016,2015-11-03,54,ES
4462,Spicewood,808,807,2015-11-03,1,ES
4463,Stony Point,2596,2570,2015-11-03,26,HS
4464,Success,351,307,2015-11-03,44,HS
4465,Teravista,863,923,2015-11-03,-60,ES
4466,Union Hill,818,883,2015-11-03,-65,ES
4467,Voigt,539,566,2015-11-03,-27,ES
4468,Walsh,1604,1532,2015-11-03,72,MS
4469,Wells Branch,946,939,2015-11-03,7,ES
4470,Westwood,2706,2749,2015-11-03,-43,HS
4471,Anderson Mill,512,495,2015-11-10,17,ES
4472,Berkman,506,506,2015-11-10,0,ES
4473,Blackland Prairie,807,807,2015-11-10,0,ES
4474,Bluebonnet,571,567,2015-11-10,4,ES
4475,Brushy Creek,801,753,2015-11-10,48,ES
4476,C.D. Fulkes,707,732,2015-11-10,-25,MS
4477,Cactus Ranch,1027,1048,2015-11-10,-21,ES
4478,Caldwell Heights,698,660,2015-11-10,38,ES
4479,Callison,839,866,2015-11-10,-27,ES
4480,Canyon Creek,417,424,2015-11-10,-7,ES
4481,Canyon Vista,1397,1400,2015-11-10,-3,MS
4482,Caraway,731,707,2015-11-10,24,ES
4483,Cedar Ridge,2749,2726,2015-11-10,23,HS
4484,Cedar Valley,1365,1364,2015-11-10,1,MS
4485,Chandler Oaks,523,542,2015-11-10,-19,ES
4486,Chisholm Trail,1046,1069,2015-11-10,-23,MS
4487,Deepwood,369,404,2015-11-10,-35,ES
4488,Deerpark,905,958,2015-11-10,-53,MS
4489,Double File Trail,600,655,2015-11-10,-55,ES
4490,DAEP,4,5,2015-11-10,-1,Other
4491,England,899,891,2015-11-10,8,ES
4492,Fern Bluff,655,655,2015-11-10,0,ES
4493,Forest Creek,810,837,2015-11-10,-27,ES
4494,Forest North,395,411,2015-11-10,-16,ES
4495,Gattis,742,797,2015-11-10,-55,ES
4496,Great Oaks,718,684,2015-11-10,34,ES
4497,Grisham,697,653,2015-11-10,44,MS
4498,Hernandez,813,802,2015-11-10,11,MS
4499,Herrington,889,916,2015-11-10,-27,ES
4500,Hopewell,993,1054,2015-11-10,-61,MS
4501,JJAEP,23,29,2015-11-10,-6,Other
4502,Jollyville,465,481,2015-11-10,-16,ES
4503,Laurel Mountain,800,780,2015-11-10,20,ES
4504,Live Oak,569,539,2015-11-10,30,ES
4505,McNeil,2627,2638,2015-11-10,-11,HS
4506,Old Town,672,694,2015-11-10,-22,ES
4507,Pond Springs,635,658,2015-11-10,-23,ES
4508,Purple Sage,331,341,2015-11-10,-10,ES
4509,Round Rock Opportunity Center,66,52,2015-11-10,14,Other
4510,Ridgeview,1375,1375,2015-11-10,0,MS
4511,Robertson,485,512,2015-11-10,-27,ES
4512,Round Rock,3130,3175,2015-11-10,-45,HS
4513,Sommer,1070,1016,2015-11-10,54,ES
4514,Spicewood,809,807,2015-11-10,2,ES
4515,Stony Point,2591,2570,2015-11-10,21,HS
4516,Success,338,307,2015-11-10,31,HS
4517,Teravista,863,923,2015-11-10,-60,ES
4518,Union Hill,818,883,2015-11-10,-65,ES
4519,Voigt,542,566,2015-11-10,-24,ES
4520,Walsh,1605,1532,2015-11-10,73,MS
4521,Wells Branch,940,939,2015-11-10,1,ES
4522,Westwood,2701,2749,2015-11-10,-48,HS
4523,Anderson Mill,512,495,2015-11-17,17,ES
4524,Berkman,506,506,2015-11-17,0,ES
4525,Blackland Prairie,807,807,2015-11-17,0,ES
4526,Bluebonnet,566,567,2015-11-17,-1,ES
4527,Brushy Creek,801,753,2015-11-17,48,ES
4528,C.D. Fulkes,706,732,2015-11-17,-26,MS
4529,Cactus Ranch,1031,1048,2015-11-17,-17,ES
4530,Caldwell Heights,702,660,2015-11-17,42,ES
4531,Callison,840,866,2015-11-17,-26,ES
4532,Canyon Creek,417,424,2015-11-17,-7,ES
4533,Canyon Vista,1397,1400,2015-11-17,-3,MS
4534,Caraway,732,707,2015-11-17,25,ES
4535,Cedar Ridge,2748,2726,2015-11-17,22,HS
4536,Cedar Valley,1365,1364,2015-11-17,1,MS
4537,Chandler Oaks,523,542,2015-11-17,-19,ES
4538,Chisholm Trail,1048,1069,2015-11-17,-21,MS
4539,Deepwood,371,404,2015-11-17,-33,ES
4540,Deerpark,901,958,2015-11-17,-57,MS
4541,Double File Trail,599,655,2015-11-17,-56,ES
4542,DAEP,6,5,2015-11-17,1,Other
4543,England,898,891,2015-11-17,7,ES
4544,Fern Bluff,655,655,2015-11-17,0,ES
4545,Forest Creek,808,837,2015-11-17,-29,ES
4546,Forest North,393,411,2015-11-17,-18,ES
4547,Gattis,741,797,2015-11-17,-56,ES
4548,Great Oaks,718,684,2015-11-17,34,ES
4549,Grisham,697,653,2015-11-17,44,MS
4550,Hernandez,808,802,2015-11-17,6,MS
4551,Herrington,891,916,2015-11-17,-25,ES
4552,Hopewell,992,1054,2015-11-17,-62,MS
4553,JJAEP,23,29,2015-11-17,-6,Other
4554,Jollyville,468,481,2015-11-17,-13,ES
4555,Laurel Mountain,800,780,2015-11-17,20,ES
4556,Live Oak,568,539,2015-11-17,29,ES
4557,McNeil,2621,2638,2015-11-17,-17,HS
4558,Old Town,672,694,2015-11-17,-22,ES
4559,Pond Springs,635,658,2015-11-17,-23,ES
4560,Purple Sage,330,341,2015-11-17,-11,ES
4561,Round Rock Opportunity Center,73,52,2015-11-17,21,Other
4562,Ridgeview,1376,1375,2015-11-17,1,MS
4563,Robertson,482,512,2015-11-17,-30,ES
4564,Round Rock,3127,3175,2015-11-17,-48,HS
4565,Sommer,1071,1016,2015-11-17,55,ES
4566,Spicewood,813,807,2015-11-17,6,ES
4567,Stony Point,2588,2570,2015-11-17,18,HS
4568,Success,340,307,2015-11-17,33,HS
4569,Teravista,864,923,2015-11-17,-59,ES
4570,Union Hill,817,883,2015-11-17,-66,ES
4571,Voigt,543,566,2015-11-17,-23,ES
4572,Walsh,1602,1532,2015-11-17,70,MS
4573,Wells Branch,940,939,2015-11-17,1,ES
4574,Westwood,2697,2749,2015-11-17,-52,HS
4575,Anderson Mill,514,495,2015-12-01,19,ES
4576,Berkman,502,506,2015-12-01,-4,ES
4577,Blackland Prairie,804,807,2015-12-01,-3,ES
4578,Bluebonnet,565,567,2015-12-01,-2,ES
4579,Brushy Creek,798,753,2015-12-01,45,ES
4580,C.D. Fulkes,703,732,2015-12-01,-29,MS
4581,Cactus Ranch,1034,1048,2015-12-01,-14,ES
4582,Caldwell Heights,696,660,2015-12-01,36,ES
4583,Callison,834,866,2015-12-01,-32,ES
4584,Canyon Creek,421,424,2015-12-01,-3,ES
4585,Canyon Vista,1395,1400,2015-12-01,-5,MS
4586,Caraway,733,707,2015-12-01,26,ES
4587,Cedar Ridge,2739,2726,2015-12-01,13,HS
4588,Cedar Valley,1362,1364,2015-12-01,-2,MS
4589,Chandler Oaks,526,542,2015-12-01,-16,ES
4590,Chisholm Trail,1047,1069,2015-12-01,-22,MS
4591,Deepwood,373,404,2015-12-01,-31,ES
4592,Deerpark,903,958,2015-12-01,-55,MS
4593,Double File Trail,596,655,2015-12-01,-59,ES
4594,DAEP,5,5,2015-12-01,0,Other
4595,England,900,891,2015-12-01,9,ES
4596,Fern Bluff,657,655,2015-12-01,2,ES
4597,Forest Creek,806,837,2015-12-01,-31,ES
4598,Forest North,385,411,2015-12-01,-26,ES
4599,Gattis,744,797,2015-12-01,-53,ES
4600,Great Oaks,715,684,2015-12-01,31,ES
4601,Grisham,697,653,2015-12-01,44,MS
4602,Hernandez,803,802,2015-12-01,1,MS
4603,Herrington,890,916,2015-12-01,-26,ES
4604,Hopewell,996,1054,2015-12-01,-58,MS
4605,JJAEP,25,29,2015-12-01,-4,Other
4606,Jollyville,464,481,2015-12-01,-17,ES
4607,Laurel Mountain,796,780,2015-12-01,16,ES
4608,Live Oak,560,539,2015-12-01,21,ES
4609,McNeil,2622,2638,2015-12-01,-16,HS
4610,Old Town,673,694,2015-12-01,-21,ES
4611,Pond Springs,637,658,2015-12-01,-21,ES
4612,Purple Sage,329,341,2015-12-01,-12,ES
4613,Round Rock Opportunity Center,77,52,2015-12-01,25,Other
4614,Ridgeview,1376,1375,2015-12-01,1,MS
4615,Robertson,478,512,2015-12-01,-34,ES
4616,Round Rock,3122,3175,2015-12-01,-53,HS
4617,Sommer,1079,1016,2015-12-01,63,ES
4618,Spicewood,816,807,2015-12-01,9,ES
4619,Stony Point,2588,2570,2015-12-01,18,HS
4620,Success,347,307,2015-12-01,40,HS
4621,Teravista,863,923,2015-12-01,-60,ES
4622,Union Hill,821,883,2015-12-01,-62,ES
4623,Voigt,544,566,2015-12-01,-22,ES
4624,Walsh,1601,1532,2015-12-01,69,MS
4625,Wells Branch,935,939,2015-12-01,-4,ES
4626,Westwood,2694,2749,2015-12-01,-55,HS
4627,Anderson Mill,512,495,2015-12-08,17,ES
4628,Berkman,503,506,2015-12-08,-3,ES
4629,Blackland Prairie,806,807,2015-12-08,-1,ES
4630,Bluebonnet,565,567,2015-12-08,-2,ES
4631,Brushy Creek,798,753,2015-12-08,45,ES
4632,C.D. Fulkes,702,732,2015-12-08,-30,MS
4633,Cactus Ranch,1033,1048,2015-12-08,-15,ES
4634,Caldwell Heights,695,660,2015-12-08,35,ES
4635,Callison,831,866,2015-12-08,-35,ES
4636,Canyon Creek,421,424,2015-12-08,-3,ES
4637,Canyon Vista,1397,1400,2015-12-08,-3,MS
4638,Caraway,733,707,2015-12-08,26,ES
4639,Cedar Ridge,2738,2726,2015-12-08,12,HS
4640,Cedar Valley,1358,1364,2015-12-08,-6,MS
4641,Chandler Oaks,527,542,2015-12-08,-15,ES
4642,Chisholm Trail,1049,1069,2015-12-08,-20,MS
4643,Deepwood,373,404,2015-12-08,-31,ES
4644,Deerpark,906,958,2015-12-08,-52,MS
4645,Double File Trail,593,655,2015-12-08,-62,ES
4646,DAEP,5,5,2015-12-08,0,Other
4647,England,903,891,2015-12-08,12,ES
4648,Fern Bluff,657,655,2015-12-08,2,ES
4649,Forest Creek,809,837,2015-12-08,-28,ES
4650,Forest North,388,411,2015-12-08,-23,ES
4651,Gattis,746,797,2015-12-08,-51,ES
4652,Great Oaks,721,684,2015-12-08,37,ES
4653,Grisham,694,653,2015-12-08,41,MS
4654,Hernandez,803,802,2015-12-08,1,MS
4655,Herrington,891,916,2015-12-08,-25,ES
4656,Hopewell,992,1054,2015-12-08,-62,MS
4657,JJAEP,25,29,2015-12-08,-4,Other
4658,Jollyville,464,481,2015-12-08,-17,ES
4659,Laurel Mountain,795,780,2015-12-08,15,ES
4660,Live Oak,558,539,2015-12-08,19,ES
4661,McNeil,2619,2638,2015-12-08,-19,HS
4662,Old Town,674,694,2015-12-08,-20,ES
4663,Pond Springs,637,658,2015-12-08,-21,ES
4664,Purple Sage,331,341,2015-12-08,-10,ES
4665,Round Rock Opportunity Center,85,52,2015-12-08,33,Other
4666,Ridgeview,1379,1375,2015-12-08,4,MS
4667,Robertson,477,512,2015-12-08,-35,ES
4668,Round Rock,3121,3175,2015-12-08,-54,HS
4669,Sommer,1079,1016,2015-12-08,63,ES
4670,Spicewood,815,807,2015-12-08,8,ES
4671,Stony Point,2589,2570,2015-12-08,19,HS
4672,Success,334,307,2015-12-08,27,HS
4673,Teravista,862,923,2015-12-08,-61,ES
4674,Union Hill,820,883,2015-12-08,-63,ES
4675,Voigt,546,566,2015-12-08,-20,ES
4676,Walsh,1601,1532,2015-12-08,69,MS
4677,Wells Branch,939,939,2015-12-08,0,ES
4678,Westwood,2690,2749,2015-12-08,-59,HS
4679,Anderson Mill,512,495,2015-12-15,17,ES
4680,Berkman,505,506,2015-12-15,-1,ES
4681,Blackland Prairie,804,807,2015-12-15,-3,ES
4682,Bluebonnet,568,567,2015-12-15,1,ES
4683,Brushy Creek,800,753,2015-12-15,47,ES
4684,C.D. Fulkes,701,732,2015-12-15,-31,MS
4685,Cactus Ranch,1033,1048,2015-12-15,-15,ES
4686,Caldwell Heights,694,660,2015-12-15,34,ES
4687,Callison,834,866,2015-12-15,-32,ES
4688,Canyon Creek,421,424,2015-12-15,-3,ES
4689,Canyon Vista,1397,1400,2015-12-15,-3,MS
4690,Caraway,732,707,2015-12-15,25,ES
4691,Cedar Ridge,2738,2726,2015-12-15,12,HS
4692,Cedar Valley,1354,1364,2015-12-15,-10,MS
4693,Chandler Oaks,527,542,2015-12-15,-15,ES
4694,Chisholm Trail,1048,1069,2015-12-15,-21,MS
4695,Deepwood,372,404,2015-12-15,-32,ES
4696,Deerpark,905,958,2015-12-15,-53,MS
4697,Double File Trail,591,655,2015-12-15,-64,ES
4698,DAEP,6,5,2015-12-15,1,Other
4699,England,903,891,2015-12-15,12,ES
4700,Fern Bluff,658,655,2015-12-15,3,ES
4701,Forest Creek,810,837,2015-12-15,-27,ES
4702,Forest North,388,411,2015-12-15,-23,ES
4703,Gattis,745,797,2015-12-15,-52,ES
4704,Great Oaks,719,684,2015-12-15,35,ES
4705,Grisham,690,653,2015-12-15,37,MS
4706,Hernandez,803,802,2015-12-15,1,MS
4707,Herrington,888,916,2015-12-15,-28,ES
4708,Hopewell,991,1054,2015-12-15,-63,MS
4709,JJAEP,25,29,2015-12-15,-4,Other
4710,Jollyville,465,481,2015-12-15,-16,ES
4711,Laurel Mountain,797,780,2015-12-15,17,ES
4712,Live Oak,558,539,2015-12-15,19,ES
4713,McNeil,2619,2638,2015-12-15,-19,HS
4714,Old Town,675,694,2015-12-15,-19,ES
4715,Pond Springs,635,658,2015-12-15,-23,ES
4716,Purple Sage,332,341,2015-12-15,-9,ES
4717,Round Rock Opportunity Center,85,52,2015-12-15,33,Other
4718,Ridgeview,1379,1375,2015-12-15,4,MS
4719,Robertson,476,512,2015-12-15,-36,ES
4720,Round Rock,3121,3175,2015-12-15,-54,HS
4721,Sommer,1080,1016,2015-12-15,64,ES
4722,Spicewood,817,807,2015-12-15,10,ES
4723,Stony Point,2589,2570,2015-12-15,19,HS
4724,Success,334,307,2015-12-15,27,HS
4725,Teravista,865,923,2015-12-15,-58,ES
4726,Union Hill,821,883,2015-12-15,-62,ES
4727,Voigt,542,566,2015-12-15,-24,ES
4728,Walsh,1599,1532,2015-12-15,67,MS
4729,Wells Branch,939,939,2015-12-15,0,ES
4730,Westwood,2690,2749,2015-12-15,-59,HS
4731,Anderson Mill,513,495,2016-01-05,18,ES
4732,Berkman,515,506,2016-01-05,9,ES
4733,Blackland Prairie,807,807,2016-01-05,0,ES
4734,Bluebonnet,572,567,2016-01-05,5,ES
4735,Brushy Creek,805,753,2016-01-05,52,ES
4736,C.D. Fulkes,712,732,2016-01-05,-20,MS
4737,Cactus Ranch,1035,1048,2016-01-05,-13,ES
4738,Caldwell Heights,702,660,2016-01-05,42,ES
4739,Callison,834,866,2016-01-05,-32,ES
4740,Canyon Creek,418,424,2016-01-05,-6,ES
4741,Canyon Vista,1404,1400,2016-01-05,4,MS
4742,Caraway,729,707,2016-01-05,22,ES
4743,Cedar Ridge,2746,2726,2016-01-05,20,HS
4744,Cedar Valley,1360,1364,2016-01-05,-4,MS
4745,Chandler Oaks,529,542,2016-01-05,-13,ES
4746,Chisholm Trail,1050,1069,2016-01-05,-19,MS
4747,Deepwood,377,404,2016-01-05,-27,ES
4748,Deerpark,896,958,2016-01-05,-62,MS
4749,Double File Trail,592,655,2016-01-05,-63,ES
4750,DAEP,4,5,2016-01-05,-1,Other
4751,England,903,891,2016-01-05,12,ES
4752,Fern Bluff,657,655,2016-01-05,2,ES
4753,Forest Creek,815,837,2016-01-05,-22,ES
4754,Forest North,385,411,2016-01-05,-26,ES
4755,Gattis,742,797,2016-01-05,-55,ES
4756,Great Oaks,722,684,2016-01-05,38,ES
4757,Grisham,699,653,2016-01-05,46,MS
4758,Hernandez,807,802,2016-01-05,5,MS
4759,Herrington,897,916,2016-01-05,-19,ES
4760,Hopewell,995,1054,2016-01-05,-59,MS
4761,JJAEP,16,29,2016-01-05,-13,Other
4762,Jollyville,460,481,2016-01-05,-21,ES
4763,Laurel Mountain,803,780,2016-01-05,23,ES
4764,Live Oak,553,539,2016-01-05,14,ES
4765,McNeil,2636,2638,2016-01-05,-2,HS
4766,Old Town,683,694,2016-01-05,-11,ES
4767,Pond Springs,633,658,2016-01-05,-25,ES
4768,Purple Sage,332,341,2016-01-05,-9,ES
4769,Round Rock Opportunity Center,67,52,2016-01-05,15,Other
4770,Ridgeview,1372,1375,2016-01-05,-3,MS
4771,Robertson,476,512,2016-01-05,-36,ES
4772,Round Rock,3116,3175,2016-01-05,-59,HS
4773,Sommer,1081,1016,2016-01-05,65,ES
4774,Spicewood,818,807,2016-01-05,11,ES
4775,Stony Point,2590,2570,2016-01-05,20,HS
4776,Success,321,307,2016-01-05,14,HS
4777,Teravista,871,923,2016-01-05,-52,ES
4778,Union Hill,822,883,2016-01-05,-61,ES
4779,Voigt,548,566,2016-01-05,-18,ES
4780,Walsh,1598,1532,2016-01-05,66,MS
4781,Wells Branch,925,939,2016-01-05,-14,ES
4782,Westwood,2694,2749,2016-01-05,-55,HS
4783,Anderson Mill,514,495,2016-01-12,19,ES
4784,Berkman,493,506,2016-01-12,-13,ES
4785,Blackland Prairie,806,807,2016-01-12,-1,ES
4786,Bluebonnet,564,567,2016-01-12,-3,ES
4787,Brushy Creek,809,753,2016-01-12,56,ES
4788,C.D. Fulkes,717,732,2016-01-12,-15,MS
4789,Cactus Ranch,1040,1048,2016-01-12,-8,ES
4790,Caldwell Heights,693,660,2016-01-12,33,ES
4791,Callison,837,866,2016-01-12,-29,ES
4792,Canyon Creek,418,424,2016-01-12,-6,ES
4793,Canyon Vista,1396,1400,2016-01-12,-4,MS
4794,Caraway,731,707,2016-01-12,24,ES
4795,Cedar Ridge,2736,2726,2016-01-12,10,HS
4796,Cedar Valley,1359,1364,2016-01-12,-5,MS
4797,Chandler Oaks,530,542,2016-01-12,-12,ES
4798,Chisholm Trail,1054,1069,2016-01-12,-15,MS
4799,Deepwood,379,404,2016-01-12,-25,ES
4800,Deerpark,890,958,2016-01-12,-68,MS
4801,Double File Trail,593,655,2016-01-12,-62,ES
4802,DAEP,5,5,2016-01-12,0,Other
4803,England,905,891,2016-01-12,14,ES
4804,Fern Bluff,660,655,2016-01-12,5,ES
4805,Forest Creek,816,837,2016-01-12,-21,ES
4806,Forest North,380,411,2016-01-12,-31,ES
4807,Gattis,742,797,2016-01-12,-55,ES
4808,Great Oaks,718,684,2016-01-12,34,ES
4809,Grisham,702,653,2016-01-12,49,MS
4810,Hernandez,790,802,2016-01-12,-12,MS
4811,Herrington,903,916,2016-01-12,-13,ES
4812,Hopewell,983,1054,2016-01-12,-71,MS
4813,JJAEP,22,29,2016-01-12,-7,Other
4814,Jollyville,463,481,2016-01-12,-18,ES
4815,Laurel Mountain,804,780,2016-01-12,24,ES
4816,Live Oak,558,539,2016-01-12,19,ES
4817,McNeil,2598,2638,2016-01-12,-40,HS
4818,Old Town,684,694,2016-01-12,-10,ES
4819,Pond Springs,636,658,2016-01-12,-22,ES
4820,Purple Sage,334,341,2016-01-12,-7,ES
4821,Round Rock Opportunity Center,79,52,2016-01-12,27,Other
4822,Ridgeview,1375,1375,2016-01-12,0,MS
4823,Robertson,476,512,2016-01-12,-36,ES
4824,Round Rock,3120,3175,2016-01-12,-55,HS
4825,Sommer,1081,1016,2016-01-12,65,ES
4826,Spicewood,821,807,2016-01-12,14,ES
4827,Stony Point,2576,2570,2016-01-12,6,HS
4828,Success,327,307,2016-01-12,20,HS
4829,Teravista,865,923,2016-01-12,-58,ES
4830,Union Hill,824,883,2016-01-12,-59,ES
4831,Voigt,549,566,2016-01-12,-17,ES
4832,Walsh,1601,1532,2016-01-12,69,MS
4833,Wells Branch,931,939,2016-01-12,-8,ES
4834,Westwood,2671,2749,2016-01-12,-78,HS
4835,Anderson Mill,512,495,2016-01-19,17,ES
4836,Berkman,495,506,2016-01-19,-11,ES
4837,Blackland Prairie,806,807,2016-01-19,-1,ES
4838,Bluebonnet,563,567,2016-01-19,-4,ES
4839,Brushy Creek,808,753,2016-01-19,55,ES
4840,C.D. Fulkes,714,732,2016-01-19,-18,MS
4841,Cactus Ranch,1040,1048,2016-01-19,-8,ES
4842,Caldwell Heights,694,660,2016-01-19,34,ES
4843,Callison,837,866,2016-01-19,-29,ES
4844,Canyon Creek,419,424,2016-01-19,-5,ES
4845,Canyon Vista,1395,1400,2016-01-19,-5,MS
4846,Caraway,732,707,2016-01-19,25,ES
4847,Cedar Ridge,2736,2726,2016-01-19,10,HS
4848,Cedar Valley,1362,1364,2016-01-19,-2,MS
4849,Chandler Oaks,530,542,2016-01-19,-12,ES
4850,Chisholm Trail,1052,1069,2016-01-19,-17,MS
4851,Deepwood,378,404,2016-01-19,-26,ES
4852,Deerpark,887,958,2016-01-19,-71,MS
4853,Double File Trail,593,655,2016-01-19,-62,ES
4854,DAEP,7,5,2016-01-19,2,Other
4855,England,906,891,2016-01-19,15,ES
4856,Fern Bluff,660,655,2016-01-19,5,ES
4857,Forest Creek,817,837,2016-01-19,-20,ES
4858,Forest North,379,411,2016-01-19,-32,ES
4859,Gattis,741,797,2016-01-19,-56,ES
4860,Great Oaks,717,684,2016-01-19,33,ES
4861,Grisham,702,653,2016-01-19,49,MS
4862,Hernandez,791,802,2016-01-19,-11,MS
4863,Herrington,903,916,2016-01-19,-13,ES
4864,Hopewell,986,1054,2016-01-19,-68,MS
4865,JJAEP,23,29,2016-01-19,-6,Other
4866,Jollyville,464,481,2016-01-19,-17,ES
4867,Laurel Mountain,803,780,2016-01-19,23,ES
4868,Live Oak,561,539,2016-01-19,22,ES
4869,McNeil,2589,2638,2016-01-19,-49,HS
4870,Old Town,683,694,2016-01-19,-11,ES
4871,Pond Springs,638,658,2016-01-19,-20,ES
4872,Purple Sage,335,341,2016-01-19,-6,ES
4873,Round Rock Opportunity Center,86,52,2016-01-19,34,Other
4874,Ridgeview,1376,1375,2016-01-19,1,MS
4875,Robertson,475,512,2016-01-19,-37,ES
4876,Round Rock,3122,3175,2016-01-19,-53,HS
4877,Sommer,1083,1016,2016-01-19,67,ES
4878,Spicewood,821,807,2016-01-19,14,ES
4879,Stony Point,2567,2570,2016-01-19,-3,HS
4880,Success,327,307,2016-01-19,20,HS
4881,Teravista,866,923,2016-01-19,-57,ES
4882,Union Hill,820,883,2016-01-19,-63,ES
4883,Voigt,542,566,2016-01-19,-24,ES
4884,Walsh,1601,1532,2016-01-19,69,MS
4885,Wells Branch,931,939,2016-01-19,-8,ES
4886,Westwood,2674,2749,2016-01-19,-75,HS
4887,Anderson Mill,515,495,2016-01-26,20,ES
4888,Berkman,494,506,2016-01-26,-12,ES
4889,Blackland Prairie,805,807,2016-01-26,-2,ES
4890,Bluebonnet,567,567,2016-01-26,0,ES
4891,Brushy Creek,811,753,2016-01-26,58,ES
4892,C.D. Fulkes,713,732,2016-01-26,-19,MS
4893,Cactus Ranch,1040,1048,2016-01-26,-8,ES
4894,Caldwell Heights,700,660,2016-01-26,40,ES
4895,Callison,836,866,2016-01-26,-30,ES
4896,Canyon Creek,420,424,2016-01-26,-4,ES
4897,Canyon Vista,1397,1400,2016-01-26,-3,MS
4898,Caraway,727,707,2016-01-26,20,ES
4899,Cedar Ridge,2728,2726,2016-01-26,2,HS
4900,Cedar Valley,1363,1364,2016-01-26,-1,MS
4901,Chandler Oaks,530,542,2016-01-26,-12,ES
4902,Chisholm Trail,1052,1069,2016-01-26,-17,MS
4903,Deepwood,376,404,2016-01-26,-28,ES
4904,Deerpark,886,958,2016-01-26,-72,MS
4905,Double File Trail,596,655,2016-01-26,-59,ES
4906,DAEP,5,5,2016-01-26,0,Other
4907,England,902,891,2016-01-26,11,ES
4908,Fern Bluff,659,655,2016-01-26,4,ES
4909,Forest Creek,817,837,2016-01-26,-20,ES
4910,Forest North,380,411,2016-01-26,-31,ES
4911,Gattis,745,797,2016-01-26,-52,ES
4912,Great Oaks,717,684,2016-01-26,33,ES
4913,Grisham,706,653,2016-01-26,53,MS
4914,Hernandez,793,802,2016-01-26,-9,MS
4915,Herrington,903,916,2016-01-26,-13,ES
4916,Hopewell,984,1054,2016-01-26,-70,MS
4917,JJAEP,20,29,2016-01-26,-9,Other
4918,Jollyville,465,481,2016-01-26,-16,ES
4919,Laurel Mountain,802,780,2016-01-26,22,ES
4920,Live Oak,558,539,2016-01-26,19,ES
4921,McNeil,2580,2638,2016-01-26,-58,HS
4922,Old Town,684,694,2016-01-26,-10,ES
4923,Pond Springs,638,658,2016-01-26,-20,ES
4924,Purple Sage,336,341,2016-01-26,-5,ES
4925,Round Rock Opportunity Center,98,52,2016-01-26,46,Other
4926,Ridgeview,1379,1375,2016-01-26,4,MS
4927,Robertson,474,512,2016-01-26,-38,ES
4928,Round Rock,3110,3175,2016-01-26,-65,HS
4929,Sommer,1085,1016,2016-01-26,69,ES
4930,Spicewood,821,807,2016-01-26,14,ES
4931,Stony Point,2562,2570,2016-01-26,-8,HS
4932,Success,352,307,2016-01-26,45,HS
4933,Teravista,863,923,2016-01-26,-60,ES
4934,Union Hill,820,883,2016-01-26,-63,ES
4935,Voigt,541,566,2016-01-26,-25,ES
4936,Walsh,1601,1532,2016-01-26,69,MS
4937,Wells Branch,934,939,2016-01-26,-5,ES
4938,Westwood,2672,2749,2016-01-26,-77,HS
4939,Anderson Mill,515,495,2016-02-02,20,ES
4940,Berkman,490,506,2016-02-02,-16,ES
4941,Blackland Prairie,805,807,2016-02-02,-2,ES
4942,Bluebonnet,567,567,2016-02-02,0,ES
4943,Brushy Creek,814,753,2016-02-02,61,ES
4944,C.D. Fulkes,715,732,2016-02-02,-17,MS
4945,Cactus Ranch,1039,1048,2016-02-02,-9,ES
4946,Caldwell Heights,698,660,2016-02-02,38,ES
4947,Callison,840,866,2016-02-02,-26,ES
4948,Canyon Creek,420,424,2016-02-02,-4,ES
4949,Canyon Vista,1396,1400,2016-02-02,-4,MS
4950,Caraway,728,707,2016-02-02,21,ES
4951,Cedar Ridge,2723,2726,2016-02-02,-3,HS
4952,Cedar Valley,1363,1364,2016-02-02,-1,MS
4953,Chandler Oaks,528,542,2016-02-02,-14,ES
4954,Chisholm Trail,1047,1069,2016-02-02,-22,MS
4955,Deepwood,373,404,2016-02-02,-31,ES
4956,Deerpark,884,958,2016-02-02,-74,MS
4957,Double File Trail,594,655,2016-02-02,-61,ES
4958,DAEP,6,5,2016-02-02,1,Other
4959,England,902,891,2016-02-02,11,ES
4960,Fern Bluff,659,655,2016-02-02,4,ES
4961,Forest Creek,817,837,2016-02-02,-20,ES
4962,Forest North,383,411,2016-02-02,-28,ES
4963,Gattis,744,797,2016-02-02,-53,ES
4964,Great Oaks,718,684,2016-02-02,34,ES
4965,Grisham,707,653,2016-02-02,54,MS
4966,Hernandez,788,802,2016-02-02,-14,MS
4967,Herrington,904,916,2016-02-02,-12,ES
4968,Hopewell,987,1054,2016-02-02,-67,MS
4969,JJAEP,19,29,2016-02-02,-10,Other
4970,Jollyville,463,481,2016-02-02,-18,ES
4971,Laurel Mountain,803,780,2016-02-02,23,ES
4972,Live Oak,560,539,2016-02-02,21,ES
4973,McNeil,2572,2638,2016-02-02,-66,HS
4974,Old Town,684,694,2016-02-02,-10,ES
4975,Pond Springs,641,658,2016-02-02,-17,ES
4976,Purple Sage,334,341,2016-02-02,-7,ES
4977,Round Rock Opportunity Center,112,52,2016-02-02,60,Other
4978,Ridgeview,1374,1375,2016-02-02,-1,MS
4979,Robertson,474,512,2016-02-02,-38,ES
4980,Round Rock,3108,3175,2016-02-02,-67,HS
4981,Sommer,1085,1016,2016-02-02,69,ES
4982,Spicewood,821,807,2016-02-02,14,ES
4983,Stony Point,2564,2570,2016-02-02,-6,HS
4984,Success,333,307,2016-02-02,26,HS
4985,Teravista,862,923,2016-02-02,-61,ES
4986,Union Hill,820,883,2016-02-02,-63,ES
4987,Voigt,538,566,2016-02-02,-28,ES
4988,Walsh,1601,1532,2016-02-02,69,MS
4989,Wells Branch,928,939,2016-02-02,-11,ES
4990,Westwood,2672,2749,2016-02-02,-77,HS
4991,Anderson Mill,517,495,2016-02-09,22,ES
4992,Berkman,488,506,2016-02-09,-18,ES
4993,Blackland Prairie,807,807,2016-02-09,0,ES
4994,Bluebonnet,565,567,2016-02-09,-2,ES
4995,Brushy Creek,817,753,2016-02-09,64,ES
4996,C.D. Fulkes,715,732,2016-02-09,-17,MS
4997,Cactus Ranch,1039,1048,2016-02-09,-9,ES
4998,Caldwell Heights,695,660,2016-02-09,35,ES
4999,Callison,838,866,2016-02-09,-28,ES
5000,Canyon Creek,420,424,2016-02-09,-4,ES
5001,Canyon Vista,1395,1400,2016-02-09,-5,MS
5002,Caraway,726,707,2016-02-09,19,ES
5003,Cedar Ridge,2716,2726,2016-02-09,-10,HS
5004,Cedar Valley,1366,1364,2016-02-09,2,MS
5005,Chandler Oaks,531,542,2016-02-09,-11,ES
5006,Chisholm Trail,1048,1069,2016-02-09,-21,MS
5007,Deepwood,373,404,2016-02-09,-31,ES
5008,Deerpark,883,958,2016-02-09,-75,MS
5009,Double File Trail,596,655,2016-02-09,-59,ES
5010,DAEP,6,5,2016-02-09,1,Other
5011,England,906,891,2016-02-09,15,ES
5012,Fern Bluff,660,655,2016-02-09,5,ES
5013,Forest Creek,819,837,2016-02-09,-18,ES
5014,Forest North,383,411,2016-02-09,-28,ES
5015,Gattis,745,797,2016-02-09,-52,ES
5016,Great Oaks,718,684,2016-02-09,34,ES
5017,Grisham,711,653,2016-02-09,58,MS
5018,Hernandez,787,802,2016-02-09,-15,MS
5019,Herrington,904,916,2016-02-09,-12,ES
5020,Hopewell,987,1054,2016-02-09,-67,MS
5021,JJAEP,21,29,2016-02-09,-8,Other
5022,Jollyville,461,481,2016-02-09,-20,ES
5023,Laurel Mountain,803,780,2016-02-09,23,ES
5024,Live Oak,560,539,2016-02-09,21,ES
5025,McNeil,2567,2638,2016-02-09,-71,HS
5026,Old Town,683,694,2016-02-09,-11,ES
5027,Pond Springs,640,658,2016-02-09,-18,ES
5028,Purple Sage,332,341,2016-02-09,-9,ES
5029,Round Rock Opportunity Center,130,52,2016-02-09,78,Other
5030,Ridgeview,1376,1375,2016-02-09,1,MS
5031,Robertson,475,512,2016-02-09,-37,ES
5032,Round Rock,3104,3175,2016-02-09,-71,HS
5033,Sommer,1084,1016,2016-02-09,68,ES
5034,Spicewood,822,807,2016-02-09,15,ES
5035,Stony Point,2560,2570,2016-02-09,-10,HS
5036,Success,336,307,2016-02-09,29,HS
5037,Teravista,866,923,2016-02-09,-57,ES
5038,Union Hill,817,883,2016-02-09,-66,ES
5039,Voigt,543,566,2016-02-09,-23,ES
5040,Walsh,1600,1532,2016-02-09,68,MS
5041,Wells Branch,927,939,2016-02-09,-12,ES
5042,Westwood,2669,2749,2016-02-09,-80,HS
5043,Anderson Mill,519,495,2016-02-16,24,ES
5044,Berkman,488,506,2016-02-16,-18,ES
5045,Blackland Prairie,806,807,2016-02-16,-1,ES
5046,Bluebonnet,571,567,2016-02-16,4,ES
5047,Brushy Creek,817,753,2016-02-16,64,ES
5048,C.D. Fulkes,706,732,2016-02-16,-26,MS
5049,Cactus Ranch,1039,1048,2016-02-16,-9,ES
5050,Caldwell Heights,698,660,2016-02-16,38,ES
5051,Callison,838,866,2016-02-16,-28,ES
5052,Canyon Creek,419,424,2016-02-16,-5,ES
5053,Canyon Vista,1394,1400,2016-02-16,-6,MS
5054,Caraway,727,707,2016-02-16,20,ES
5055,Cedar Ridge,2705,2726,2016-02-16,-21,HS
5056,Cedar Valley,1366,1364,2016-02-16,2,MS
5057,Chandler Oaks,531,542,2016-02-16,-11,ES
5058,Chisholm Trail,1044,1069,2016-02-16,-25,MS
5059,Deepwood,375,404,2016-02-16,-29,ES
5060,Deerpark,881,958,2016-02-16,-77,MS
5061,Double File Trail,596,655,2016-02-16,-59,ES
5062,DAEP,2,5,2016-02-16,-3,Other
5063,England,907,891,2016-02-16,16,ES
5064,Fern Bluff,662,655,2016-02-16,7,ES
5065,Forest Creek,822,837,2016-02-16,-15,ES
5066,Forest North,383,411,2016-02-16,-28,ES
5067,Gattis,745,797,2016-02-16,-52,ES
5068,Great Oaks,718,684,2016-02-16,34,ES
5069,Grisham,710,653,2016-02-16,57,MS
5070,Hernandez,791,802,2016-02-16,-11,MS
5071,Herrington,904,916,2016-02-16,-12,ES
5072,Hopewell,985,1054,2016-02-16,-69,MS
5073,JJAEP,22,29,2016-02-16,-7,Other
5074,Jollyville,460,481,2016-02-16,-21,ES
5075,Laurel Mountain,802,780,2016-02-16,22,ES
5076,Live Oak,556,539,2016-02-16,17,ES
5077,McNeil,2556,2638,2016-02-16,-82,HS
5078,Old Town,686,694,2016-02-16,-8,ES
5079,Pond Springs,636,658,2016-02-16,-22,ES
5080,Purple Sage,332,341,2016-02-16,-9,ES
5081,Round Rock Opportunity Center,148,52,2016-02-16,96,Other
5082,Ridgeview,1377,1375,2016-02-16,2,MS
5083,Robertson,471,512,2016-02-16,-41,ES
5084,Round Rock,3100,3175,2016-02-16,-75,HS
5085,Sommer,1084,1016,2016-02-16,68,ES
5086,Spicewood,823,807,2016-02-16,16,ES
5087,Stony Point,2549,2570,2016-02-16,-21,HS
5088,Success,342,307,2016-02-16,35,HS
5089,Teravista,868,923,2016-02-16,-55,ES
5090,Union Hill,821,883,2016-02-16,-62,ES
5091,Voigt,543,566,2016-02-16,-23,ES
5092,Walsh,1599,1532,2016-02-16,67,MS
5093,Wells Branch,927,939,2016-02-16,-12,ES
5094,Westwood,2670,2749,2016-02-16,-79,HS
5095,Anderson Mill,517,495,2016-02-23,22,ES
5096,Berkman,488,506,2016-02-23,-18,ES
5097,Blackland Prairie,811,807,2016-02-23,4,ES
5098,Bluebonnet,570,567,2016-02-23,3,ES
5099,Brushy Creek,821,753,2016-02-23,68,ES
5100,C.D. Fulkes,706,732,2016-02-23,-26,MS
5101,Cactus Ranch,1039,1048,2016-02-23,-9,ES
5102,Caldwell Heights,700,660,2016-02-23,40,ES
5103,Callison,835,866,2016-02-23,-31,ES
5104,Canyon Creek,419,424,2016-02-23,-5,ES
5105,Canyon Vista,1400,1400,2016-02-23,0,MS
5106,Caraway,728,707,2016-02-23,21,ES
5107,Cedar Ridge,2702,2726,2016-02-23,-24,HS
5108,Cedar Valley,1370,1364,2016-02-23,6,MS
5109,Chandler Oaks,530,542,2016-02-23,-12,ES
5110,Chisholm Trail,1046,1069,2016-02-23,-23,MS
5111,Deepwood,375,404,2016-02-23,-29,ES
5112,Deerpark,886,958,2016-02-23,-72,MS
5113,Double File Trail,598,655,2016-02-23,-57,ES
5114,DAEP,3,5,2016-02-23,-2,Other
5115,England,909,891,2016-02-23,18,ES
5116,Fern Bluff,662,655,2016-02-23,7,ES
5117,Forest Creek,823,837,2016-02-23,-14,ES
5118,Forest North,379,411,2016-02-23,-32,ES
5119,Gattis,752,797,2016-02-23,-45,ES
5120,Great Oaks,722,684,2016-02-23,38,ES
5121,Grisham,708,653,2016-02-23,55,MS
5122,Hernandez,787,802,2016-02-23,-15,MS
5123,Herrington,908,916,2016-02-23,-8,ES
5124,Hopewell,984,1054,2016-02-23,-70,MS
5125,JJAEP,19,29,2016-02-23,-10,Other
5126,Jollyville,463,481,2016-02-23,-18,ES
5127,Laurel Mountain,802,780,2016-02-23,22,ES
5128,Live Oak,562,539,2016-02-23,23,ES
5129,McNeil,2562,2638,2016-02-23,-76,HS
5130,Old Town,687,694,2016-02-23,-7,ES
5131,Pond Springs,636,658,2016-02-23,-22,ES
5132,Purple Sage,332,341,2016-02-23,-9,ES
5133,Round Rock Opportunity Center,140,52,2016-02-23,88,Other
5134,Ridgeview,1378,1375,2016-02-23,3,MS
5135,Robertson,472,512,2016-02-23,-40,ES
5136,Round Rock,3096,3175,2016-02-23,-79,HS
5137,Sommer,1085,1016,2016-02-23,69,ES
5138,Spicewood,825,807,2016-02-23,18,ES
5139,Stony Point,2555,2570,2016-02-23,-15,HS
5140,Success,327,307,2016-02-23,20,HS
5141,Teravista,868,923,2016-02-23,-55,ES
5142,Union Hill,818,883,2016-02-23,-65,ES
5143,Voigt,539,566,2016-02-23,-27,ES
5144,Walsh,1598,1532,2016-02-23,66,MS
5145,Wells Branch,923,939,2016-02-23,-16,ES
5146,Westwood,2670,2749,2016-02-23,-79,HS
5147,Anderson Mill,521,495,2016-03-01,26,ES
5148,Berkman,490,506,2016-03-01,-16,ES
5149,Blackland Prairie,812,807,2016-03-01,5,ES
5150,Bluebonnet,572,567,2016-03-01,5,ES
5151,Brushy Creek,819,753,2016-03-01,66,ES
5152,C.D. Fulkes,695,732,2016-03-01,-37,MS
5153,Cactus Ranch,1037,1048,2016-03-01,-11,ES
5154,Caldwell Heights,699,660,2016-03-01,39,ES
5155,Callison,837,866,2016-03-01,-29,ES
5156,Canyon Creek,418,424,2016-03-01,-6,ES
5157,Canyon Vista,1400,1400,2016-03-01,0,MS
5158,Caraway,728,707,2016-03-01,21,ES
5159,Cedar Ridge,2698,2726,2016-03-01,-28,HS
5160,Cedar Valley,1373,1364,2016-03-01,9,MS
5161,Chandler Oaks,529,542,2016-03-01,-13,ES
5162,Chisholm Trail,1048,1069,2016-03-01,-21,MS
5163,Deepwood,374,404,2016-03-01,-30,ES
5164,Deerpark,889,958,2016-03-01,-69,MS
5165,Double File Trail,596,655,2016-03-01,-59,ES
5166,DAEP,4,5,2016-03-01,-1,Other
5167,England,911,891,2016-03-01,20,ES
5168,Fern Bluff,661,655,2016-03-01,6,ES
5169,Forest Creek,825,837,2016-03-01,-12,ES
5170,Forest North,380,411,2016-03-01,-31,ES
5171,Gattis,757,797,2016-03-01,-40,ES
5172,Great Oaks,723,684,2016-03-01,39,ES
5173,Grisham,711,653,2016-03-01,58,MS
5174,Hernandez,784,802,2016-03-01,-18,MS
5175,Herrington,907,916,2016-03-01,-9,ES
5176,Hopewell,987,1054,2016-03-01,-67,MS
5177,JJAEP,21,29,2016-03-01,-8,Other
5178,Jollyville,466,481,2016-03-01,-15,ES
5179,Laurel Mountain,801,780,2016-03-01,21,ES
5180,Live Oak,557,539,2016-03-01,18,ES
5181,McNeil,2553,2638,2016-03-01,-85,HS
5182,Old Town,685,694,2016-03-01,-9,ES
5183,Pond Springs,635,658,2016-03-01,-23,ES
5184,Purple Sage,334,341,2016-03-01,-7,ES
5185,Round Rock Opportunity Center,139,52,2016-03-01,87,Other
5186,Ridgeview,1374,1375,2016-03-01,-1,MS
5187,Robertson,471,512,2016-03-01,-41,ES
5188,Round Rock,3093,3175,2016-03-01,-82,HS
5189,Sommer,1087,1016,2016-03-01,71,ES
5190,Spicewood,825,807,2016-03-01,18,ES
5191,Stony Point,2549,2570,2016-03-01,-21,HS
5192,Success,323,307,2016-03-01,16,HS
5193,Teravista,866,923,2016-03-01,-57,ES
5194,Union Hill,812,883,2016-03-01,-71,ES
5195,Voigt,540,566,2016-03-01,-26,ES
5196,Walsh,1600,1532,2016-03-01,68,MS
5197,Wells Branch,920,939,2016-03-01,-19,ES
5198,Westwood,2669,2749,2016-03-01,-80,HS
5199,Anderson Mill,518,495,2016-03-08,23,ES
5200,Berkman,493,506,2016-03-08,-13,ES
5201,Blackland Prairie,812,807,2016-03-08,5,ES
5202,Bluebonnet,571,567,2016-03-08,4,ES
5203,Brushy Creek,822,753,2016-03-08,69,ES
5204,C.D. Fulkes,696,732,2016-03-08,-36,MS
5205,Cactus Ranch,1038,1048,2016-03-08,-10,ES
5206,Caldwell Heights,700,660,2016-03-08,40,ES
5207,Callison,840,866,2016-03-08,-26,ES
5208,Canyon Creek,418,424,2016-03-08,-6,ES
5209,Canyon Vista,1399,1400,2016-03-08,-1,MS
5210,Caraway,726,707,2016-03-08,19,ES
5211,Cedar Ridge,2696,2726,2016-03-08,-30,HS
5212,Cedar Valley,1370,1364,2016-03-08,6,MS
5213,Chandler Oaks,531,542,2016-03-08,-11,ES
5214,Chisholm Trail,1049,1069,2016-03-08,-20,MS
5215,Deepwood,375,404,2016-03-08,-29,ES
5216,Deerpark,888,958,2016-03-08,-70,MS
5217,Double File Trail,596,655,2016-03-08,-59,ES
5218,DAEP,7,5,2016-03-08,2,Other
5219,England,909,891,2016-03-08,18,ES
5220,Fern Bluff,659,655,2016-03-08,4,ES
5221,Forest Creek,826,837,2016-03-08,-11,ES
5222,Forest North,379,411,2016-03-08,-32,ES
5223,Gattis,756,797,2016-03-08,-41,ES
5224,Great Oaks,723,684,2016-03-08,39,ES
5225,Grisham,709,653,2016-03-08,56,MS
5226,Hernandez,785,802,2016-03-08,-17,MS
5227,Herrington,910,916,2016-03-08,-6,ES
5228,Hopewell,990,1054,2016-03-08,-64,MS
5229,JJAEP,21,29,2016-03-08,-8,Other
5230,Jollyville,462,481,2016-03-08,-19,ES
5231,Laurel Mountain,802,780,2016-03-08,22,ES
5232,Live Oak,558,539,2016-03-08,19,ES
5233,McNeil,2548,2638,2016-03-08,-90,HS
5234,Old Town,686,694,2016-03-08,-8,ES
5235,Pond Springs,635,658,2016-03-08,-23,ES
5236,Purple Sage,333,341,2016-03-08,-8,ES
5237,Round Rock Opportunity Center,132,52,2016-03-08,80,Other
5238,Ridgeview,1374,1375,2016-03-08,-1,MS
5239,Robertson,471,512,2016-03-08,-41,ES
5240,Round Rock,3093,3175,2016-03-08,-82,HS
5241,Sommer,1087,1016,2016-03-08,71,ES
5242,Spicewood,825,807,2016-03-08,18,ES
5243,Stony Point,2532,2570,2016-03-08,-38,HS
5244,Success,318,307,2016-03-08,11,HS
5245,Teravista,865,923,2016-03-08,-58,ES
5246,Union Hill,810,883,2016-03-08,-73,ES
5247,Voigt,537,566,2016-03-08,-29,ES
5248,Walsh,1602,1532,2016-03-08,70,MS
5249,Wells Branch,920,939,2016-03-08,-19,ES
5250,Westwood,2666,2749,2016-03-08,-83,HS
5251,Anderson Mill,518,495,2016-03-22,23,ES
5252,Berkman,493,506,2016-03-22,-13,ES
5253,Blackland Prairie,808,807,2016-03-22,1,ES
5254,Bluebonnet,573,567,2016-03-22,6,ES
5255,Brushy Creek,820,753,2016-03-22,67,ES
5256,C.D. Fulkes,697,732,2016-03-22,-35,MS
5257,Cactus Ranch,1039,1048,2016-03-22,-9,ES
5258,Caldwell Heights,694,660,2016-03-22,34,ES
5259,Callison,840,866,2016-03-22,-26,ES
5260,Canyon Creek,421,424,2016-03-22,-3,ES
5261,Canyon Vista,1403,1400,2016-03-22,3,MS
5262,Caraway,729,707,2016-03-22,22,ES
5263,Cedar Ridge,2696,2726,2016-03-22,-30,HS
5264,Cedar Valley,1368,1364,2016-03-22,4,MS
5265,Chandler Oaks,532,542,2016-03-22,-10,ES
5266,Chisholm Trail,1043,1069,2016-03-22,-26,MS
5267,Deepwood,376,404,2016-03-22,-28,ES
5268,Deerpark,886,958,2016-03-22,-72,MS
5269,Double File Trail,593,655,2016-03-22,-62,ES
5270,DAEP,8,5,2016-03-22,3,Other
5271,England,907,891,2016-03-22,16,ES
5272,Fern Bluff,659,655,2016-03-22,4,ES
5273,Forest Creek,826,837,2016-03-22,-11,ES
5274,Forest North,380,411,2016-03-22,-31,ES
5275,Gattis,758,797,2016-03-22,-39,ES
5276,Great Oaks,723,684,2016-03-22,39,ES
5277,Grisham,709,653,2016-03-22,56,MS
5278,Hernandez,787,802,2016-03-22,-15,MS
5279,Herrington,914,916,2016-03-22,-2,ES
5280,Hopewell,988,1054,2016-03-22,-66,MS
5281,JJAEP,22,29,2016-03-22,-7,Other
5282,Jollyville,461,481,2016-03-22,-20,ES
5283,Laurel Mountain,808,780,2016-03-22,28,ES
5284,Live Oak,556,539,2016-03-22,17,ES
5285,McNeil,2552,2638,2016-03-22,-86,HS
5286,Old Town,687,694,2016-03-22,-7,ES
5287,Pond Springs,642,658,2016-03-22,-16,ES
5288,Purple Sage,335,341,2016-03-22,-6,ES
5289,Round Rock Opportunity Center,138,52,2016-03-22,86,Other
5290,Ridgeview,1374,1375,2016-03-22,-1,MS
5291,Robertson,470,512,2016-03-22,-42,ES
5292,Round Rock,3090,3175,2016-03-22,-85,HS
5293,Sommer,1088,1016,2016-03-22,72,ES
5294,Spicewood,825,807,2016-03-22,18,ES
5295,Stony Point,2528,2570,2016-03-22,-42,HS
5296,Success,323,307,2016-03-22,16,HS
5297,Teravista,867,923,2016-03-22,-56,ES
5298,Union Hill,809,883,2016-03-22,-74,ES
5299,Voigt,543,566,2016-03-22,-23,ES
5300,Walsh,1605,1532,2016-03-22,73,MS
5301,Wells Branch,932,939,2016-03-22,-7,ES
5302,Westwood,2663,2749,2016-03-22,-86,HS
5303,Anderson Mill,516,495,2016-03-29,21,ES
5304,Berkman,490,506,2016-03-29,-16,ES
5305,Blackland Prairie,808,807,2016-03-29,1,ES
5306,Bluebonnet,574,567,2016-03-29,7,ES
5307,Brushy Creek,823,753,2016-03-29,70,ES
5308,C.D. Fulkes,698,732,2016-03-29,-34,MS
5309,Cactus Ranch,1038,1048,2016-03-29,-10,ES
5310,Caldwell Heights,690,660,2016-03-29,30,ES
5311,Callison,836,866,2016-03-29,-30,ES
5312,Canyon Creek,422,424,2016-03-29,-2,ES
5313,Canyon Vista,1401,1400,2016-03-29,1,MS
5314,Caraway,734,707,2016-03-29,27,ES
5315,Cedar Ridge,2698,2726,2016-03-29,-28,HS
5316,Cedar Valley,1369,1364,2016-03-29,5,MS
5317,Chandler Oaks,532,542,2016-03-29,-10,ES
5318,Chisholm Trail,1046,1069,2016-03-29,-23,MS
5319,Deepwood,376,404,2016-03-29,-28,ES
5320,Deerpark,887,958,2016-03-29,-71,MS
5321,Double File Trail,601,655,2016-03-29,-54,ES
5322,DAEP,11,5,2016-03-29,6,Other
5323,England,908,891,2016-03-29,17,ES
5324,Fern Bluff,659,655,2016-03-29,4,ES
5325,Forest Creek,826,837,2016-03-29,-11,ES
5326,Forest North,378,411,2016-03-29,-33,ES
5327,Gattis,763,797,2016-03-29,-34,ES
5328,Great Oaks,723,684,2016-03-29,39,ES
5329,Grisham,710,653,2016-03-29,57,MS
5330,Hernandez,787,802,2016-03-29,-15,MS
5331,Herrington,913,916,2016-03-29,-3,ES
5332,Hopewell,989,1054,2016-03-29,-65,MS
5333,JJAEP,23,29,2016-03-29,-6,Other
5334,Jollyville,460,481,2016-03-29,-21,ES
5335,Laurel Mountain,806,780,2016-03-29,26,ES
5336,Live Oak,557,539,2016-03-29,18,ES
5337,McNeil,2550,2638,2016-03-29,-88,HS
5338,Old Town,683,694,2016-03-29,-11,ES
5339,Pond Springs,643,658,2016-03-29,-15,ES
5340,Purple Sage,338,341,2016-03-29,-3,ES
5341,Round Rock Opportunity Center,137,52,2016-03-29,85,Other
5342,Ridgeview,1376,1375,2016-03-29,1,MS
5343,Robertson,468,512,2016-03-29,-44,ES
5344,Round Rock,3089,3175,2016-03-29,-86,HS
5345,Sommer,1088,1016,2016-03-29,72,ES
5346,Spicewood,825,807,2016-03-29,18,ES
5347,Stony Point,2520,2570,2016-03-29,-50,HS
5348,Success,311,307,2016-03-29,4,HS
5349,Teravista,870,923,2016-03-29,-53,ES
5350,Union Hill,809,883,2016-03-29,-74,ES
5351,Voigt,545,566,2016-03-29,-21,ES
5352,Walsh,1604,1532,2016-03-29,72,MS
5353,Wells Branch,928,939,2016-03-29,-11,ES
5354,Westwood,2665,2749,2016-03-29,-84,HS
5355,Anderson Mill,516,495,2016-04-06,21,ES
5356,Berkman,494,506,2016-04-06,-12,ES
5357,Blackland Prairie,808,807,2016-04-06,1,ES
5358,Bluebonnet,570,567,2016-04-06,3,ES
5359,Brushy Creek,822,753,2016-04-06,69,ES
5360,C.D. Fulkes,696,732,2016-04-06,-36,MS
5361,Cactus Ranch,1038,1048,2016-04-06,-10,ES
5362,Caldwell Heights,686,660,2016-04-06,26,ES
5363,Callison,838,866,2016-04-06,-28,ES
5364,Canyon Creek,422,424,2016-04-06,-2,ES
5365,Canyon Vista,1401,1400,2016-04-06,1,MS
5366,Caraway,730,707,2016-04-06,23,ES
5367,Cedar Ridge,2695,2726,2016-04-06,-31,HS
5368,Cedar Valley,1370,1364,2016-04-06,6,MS
5369,Chandler Oaks,532,542,2016-04-06,-10,ES
5370,Chisholm Trail,1046,1069,2016-04-06,-23,MS
5371,Deepwood,376,404,2016-04-06,-28,ES
5372,Deerpark,886,958,2016-04-06,-72,MS
5373,Double File Trail,601,655,2016-04-06,-54,ES
5374,DAEP,10,5,2016-04-06,5,Other
5375,England,908,891,2016-04-06,17,ES
5376,Fern Bluff,659,655,2016-04-06,4,ES
5377,Forest Creek,825,837,2016-04-06,-12,ES
5378,Forest North,373,411,2016-04-06,-38,ES
5379,Gattis,762,797,2016-04-06,-35,ES
5380,Great Oaks,723,684,2016-04-06,39,ES
5381,Grisham,708,653,2016-04-06,55,MS
5382,Hernandez,789,802,2016-04-06,-13,MS
5383,Herrington,914,916,2016-04-06,-2,ES
5384,Hopewell,991,1054,2016-04-06,-63,MS
5385,JJAEP,20,29,2016-04-06,-9,Other
5386,Jollyville,463,481,2016-04-06,-18,ES
5387,Laurel Mountain,807,780,2016-04-06,27,ES
5388,Live Oak,561,539,2016-04-06,22,ES
5389,McNeil,2552,2638,2016-04-06,-86,HS
5390,Old Town,682,694,2016-04-06,-12,ES
5391,Pond Springs,642,658,2016-04-06,-16,ES
5392,Purple Sage,340,341,2016-04-06,-1,ES
5393,Round Rock Opportunity Center,129,52,2016-04-06,77,Other
5394,Ridgeview,1377,1375,2016-04-06,2,MS
5395,Robertson,471,512,2016-04-06,-41,ES
5396,Round Rock,3088,3175,2016-04-06,-87,HS
5397,Sommer,1089,1016,2016-04-06,73,ES
5398,Spicewood,823,807,2016-04-06,16,ES
5399,Stony Point,2515,2570,2016-04-06,-55,HS
5400,Success,317,307,2016-04-06,10,HS
5401,Teravista,871,923,2016-04-06,-52,ES
5402,Union Hill,806,883,2016-04-06,-77,ES
5403,Voigt,544,566,2016-04-06,-22,ES
5404,Walsh,1605,1532,2016-04-06,73,MS
5405,Wells Branch,927,939,2016-04-06,-12,ES
5406,Westwood,2663,2749,2016-04-06,-86,HS
5407,Anderson Mill,522,495,2016-04-12,27,ES
5408,Berkman,492,506,2016-04-12,-14,ES
5409,Blackland Prairie,808,807,2016-04-12,1,ES
5410,Bluebonnet,570,567,2016-04-12,3,ES
5411,Brushy Creek,822,753,2016-04-12,69,ES
5412,C.D. Fulkes,696,732,2016-04-12,-36,MS
5413,Cactus Ranch,1038,1048,2016-04-12,-10,ES
5414,Caldwell Heights,689,660,2016-04-12,29,ES
5415,Callison,836,866,2016-04-12,-30,ES
5416,Canyon Creek,422,424,2016-04-12,-2,ES
5417,Canyon Vista,1404,1400,2016-04-12,4,MS
5418,Caraway,731,707,2016-04-12,24,ES
5419,Cedar Ridge,2689,2726,2016-04-12,-37,HS
5420,Cedar Valley,1370,1364,2016-04-12,6,MS
5421,Chandler Oaks,532,542,2016-04-12,-10,ES
5422,Chisholm Trail,1048,1069,2016-04-12,-21,MS
5423,Deepwood,376,404,2016-04-12,-28,ES
5424,Deerpark,886,958,2016-04-12,-72,MS
5425,Double File Trail,598,655,2016-04-12,-57,ES
5426,DAEP,11,5,2016-04-12,6,Other
5427,England,909,891,2016-04-12,18,ES
5428,Fern Bluff,659,655,2016-04-12,4,ES
5429,Forest Creek,825,837,2016-04-12,-12,ES
5430,Forest North,372,411,2016-04-12,-39,ES
5431,Gattis,761,797,2016-04-12,-36,ES
5432,Great Oaks,720,684,2016-04-12,36,ES
5433,Grisham,710,653,2016-04-12,57,MS
5434,Hernandez,787,802,2016-04-12,-15,MS
5435,Herrington,916,916,2016-04-12,0,ES
5436,Hopewell,989,1054,2016-04-12,-65,MS
5437,JJAEP,21,29,2016-04-12,-8,Other
5438,Jollyville,465,481,2016-04-12,-16,ES
5439,Laurel Mountain,805,780,2016-04-12,25,ES
5440,Live Oak,560,539,2016-04-12,21,ES
5441,McNeil,2548,2638,2016-04-12,-90,HS
5442,Old Town,682,694,2016-04-12,-12,ES
5443,Pond Springs,643,658,2016-04-12,-15,ES
5444,Purple Sage,340,341,2016-04-12,-1,ES
5445,Round Rock Opportunity Center,125,52,2016-04-12,73,Other
5446,Ridgeview,1382,1375,2016-04-12,7,MS
5447,Robertson,470,512,2016-04-12,-42,ES
5448,Round Rock,3083,3175,2016-04-12,-92,HS
5449,Sommer,1090,1016,2016-04-12,74,ES
5450,Spicewood,823,807,2016-04-12,16,ES
5451,Stony Point,2516,2570,2016-04-12,-54,HS
5452,Success,302,307,2016-04-12,-5,HS
5453,Teravista,871,923,2016-04-12,-52,ES
5454,Union Hill,811,883,2016-04-12,-72,ES
5455,Voigt,543,566,2016-04-12,-23,ES
5456,Walsh,1605,1532,2016-04-12,73,MS
5457,Wells Branch,931,939,2016-04-12,-8,ES
5458,Westwood,2662,2749,2016-04-12,-87,HS
5459,Anderson Mill,523,495,2016-04-19,28,ES
5460,Berkman,498,506,2016-04-19,-8,ES
5461,Blackland Prairie,811,807,2016-04-19,4,ES
5462,Bluebonnet,568,567,2016-04-19,1,ES
5463,Brushy Creek,821,753,2016-04-19,68,ES
5464,C.D. Fulkes,702,732,2016-04-19,-30,MS
5465,Cactus Ranch,1036,1048,2016-04-19,-12,ES
5466,Caldwell Heights,681,660,2016-04-19,21,ES
5467,Callison,837,866,2016-04-19,-29,ES
5468,Canyon Creek,422,424,2016-04-19,-2,ES
5469,Canyon Vista,1403,1400,2016-04-19,3,MS
5470,Caraway,732,707,2016-04-19,25,ES
5471,Cedar Ridge,2676,2726,2016-04-19,-50,HS
5472,Cedar Valley,1368,1364,2016-04-19,4,MS
5473,Chandler Oaks,532,542,2016-04-19,-10,ES
5474,Chisholm Trail,1050,1069,2016-04-19,-19,MS
5475,Deepwood,374,404,2016-04-19,-30,ES
5476,Deerpark,889,958,2016-04-19,-69,MS
5477,Double File Trail,598,655,2016-04-19,-57,ES
5478,DAEP,10,5,2016-04-19,5,Other
5479,England,907,891,2016-04-19,16,ES
5480,Fern Bluff,659,655,2016-04-19,4,ES
5481,Forest Creek,825,837,2016-04-19,-12,ES
5482,Forest North,373,411,2016-04-19,-38,ES
5483,Gattis,761,797,2016-04-19,-36,ES
5484,Great Oaks,720,684,2016-04-19,36,ES
5485,Grisham,705,653,2016-04-19,52,MS
5486,Hernandez,783,802,2016-04-19,-19,MS
5487,Herrington,913,916,2016-04-19,-3,ES
5488,Hopewell,989,1054,2016-04-19,-65,MS
5489,JJAEP,23,29,2016-04-19,-6,Other
5490,Jollyville,468,481,2016-04-19,-13,ES
5491,Laurel Mountain,804,780,2016-04-19,24,ES
5492,Live Oak,563,539,2016-04-19,24,ES
5493,McNeil,2547,2638,2016-04-19,-91,HS
5494,Old Town,682,694,2016-04-19,-12,ES
5495,Pond Springs,643,658,2016-04-19,-15,ES
5496,Purple Sage,336,341,2016-04-19,-5,ES
5497,Round Rock Opportunity Center,119,52,2016-04-19,67,Other
5498,Ridgeview,1381,1375,2016-04-19,6,MS
5499,Robertson,470,512,2016-04-19,-42,ES
5500,Round Rock,3075,3175,2016-04-19,-100,HS
5501,Sommer,1091,1016,2016-04-19,75,ES
5502,Spicewood,821,807,2016-04-19,14,ES
5503,Stony Point,2512,2570,2016-04-19,-58,HS
5504,Success,301,307,2016-04-19,-6,HS
5505,Teravista,868,923,2016-04-19,-55,ES
5506,Union Hill,809,883,2016-04-19,-74,ES
5507,Voigt,544,566,2016-04-19,-22,ES
5508,Walsh,1601,1532,2016-04-19,69,MS
5509,Wells Branch,935,939,2016-04-19,-4,ES
5510,Westwood,2666,2749,2016-04-19,-83,HS
5511,Anderson Mill,517,495,2016-04-26,22,ES
5512,Berkman,497,506,2016-04-26,-9,ES
5513,Blackland Prairie,811,807,2016-04-26,4,ES
5514,Bluebonnet,568,567,2016-04-26,1,ES
5515,Brushy Creek,823,753,2016-04-26,70,ES
5516,C.D. Fulkes,705,732,2016-04-26,-27,MS
5517,Cactus Ranch,1031,1048,2016-04-26,-17,ES
5518,Caldwell Heights,680,660,2016-04-26,20,ES
5519,Callison,833,866,2016-04-26,-33,ES
5520,Canyon Creek,422,424,2016-04-26,-2,ES
5521,Canyon Vista,1406,1400,2016-04-26,6,MS
5522,Caraway,735,707,2016-04-26,28,ES
5523,Cedar Ridge,2674,2726,2016-04-26,-52,HS
5524,Cedar Valley,1368,1364,2016-04-26,4,MS
5525,Chandler Oaks,532,542,2016-04-26,-10,ES
5526,Chisholm Trail,1051,1069,2016-04-26,-18,MS
5527,Deepwood,375,404,2016-04-26,-29,ES
5528,Deerpark,895,958,2016-04-26,-63,MS
5529,Double File Trail,596,655,2016-04-26,-59,ES
5530,DAEP,11,5,2016-04-26,6,Other
5531,England,908,891,2016-04-26,17,ES
5532,Fern Bluff,658,655,2016-04-26,3,ES
5533,Forest Creek,825,837,2016-04-26,-12,ES
5534,Forest North,374,411,2016-04-26,-37,ES
5535,Gattis,759,797,2016-04-26,-38,ES
5536,Great Oaks,719,684,2016-04-26,35,ES
5537,Grisham,706,653,2016-04-26,53,MS
5538,Hernandez,784,802,2016-04-26,-18,MS
5539,Herrington,913,916,2016-04-26,-3,ES
5540,Hopewell,988,1054,2016-04-26,-66,MS
5541,JJAEP,22,29,2016-04-26,-7,Other
5542,Jollyville,465,481,2016-04-26,-16,ES
5543,Laurel Mountain,806,780,2016-04-26,26,ES
5544,Live Oak,562,539,2016-04-26,23,ES
5545,McNeil,2539,2638,2016-04-26,-99,HS
5546,Old Town,680,694,2016-04-26,-14,ES
5547,Pond Springs,646,658,2016-04-26,-12,ES
5548,Purple Sage,336,341,2016-04-26,-5,ES
5549,Round Rock Opportunity Center,119,52,2016-04-26,67,Other
5550,Ridgeview,1380,1375,2016-04-26,5,MS
5551,Robertson,469,512,2016-04-26,-43,ES
5552,Round Rock,3066,3175,2016-04-26,-109,HS
5553,Sommer,1090,1016,2016-04-26,74,ES
5554,Spicewood,821,807,2016-04-26,14,ES
5555,Stony Point,2505,2570,2016-04-26,-65,HS
5556,Success,293,307,2016-04-26,-14,HS
5557,Teravista,868,923,2016-04-26,-55,ES
5558,Union Hill,810,883,2016-04-26,-73,ES
5559,Voigt,541,566,2016-04-26,-25,ES
5560,Walsh,1601,1532,2016-04-26,69,MS
5561,Wells Branch,937,939,2016-04-26,-2,ES
5562,Westwood,2666,2749,2016-04-26,-83,HS
5563,Anderson Mill,520,495,2016-05-03,25,ES
5564,Berkman,497,506,2016-05-03,-9,ES
5565,Blackland Prairie,811,807,2016-05-03,4,ES
5566,Bluebonnet,565,567,2016-05-03,-2,ES
5567,Brushy Creek,823,753,2016-05-03,70,ES
5568,C.D. Fulkes,702,732,2016-05-03,-30,MS
5569,Cactus Ranch,1031,1048,2016-05-03,-17,ES
5570,Caldwell Heights,679,660,2016-05-03,19,ES
5571,Callison,832,866,2016-05-03,-34,ES
5572,Canyon Creek,422,424,2016-05-03,-2,ES
5573,Canyon Vista,1408,1400,2016-05-03,8,MS
5574,Caraway,735,707,2016-05-03,28,ES
5575,Cedar Ridge,2668,2726,2016-05-03,-58,HS
5576,Cedar Valley,1367,1364,2016-05-03,3,MS
5577,Chandler Oaks,532,542,2016-05-03,-10,ES
5578,Chisholm Trail,1056,1069,2016-05-03,-13,MS
5579,Deepwood,375,404,2016-05-03,-29,ES
5580,Deerpark,896,958,2016-05-03,-62,MS
5581,Double File Trail,593,655,2016-05-03,-62,ES
5582,DAEP,7,5,2016-05-03,2,Other
5583,England,908,891,2016-05-03,17,ES
5584,Fern Bluff,658,655,2016-05-03,3,ES
5585,Forest Creek,823,837,2016-05-03,-14,ES
5586,Forest North,374,411,2016-05-03,-37,ES
5587,Gattis,761,797,2016-05-03,-36,ES
5588,Great Oaks,718,684,2016-05-03,34,ES
5589,Grisham,707,653,2016-05-03,54,MS
5590,Hernandez,784,802,2016-05-03,-18,MS
5591,Herrington,911,916,2016-05-03,-5,ES
5592,Hopewell,992,1054,2016-05-03,-62,MS
5593,JJAEP,21,29,2016-05-03,-8,Other
5594,Jollyville,463,481,2016-05-03,-18,ES
5595,Laurel Mountain,806,780,2016-05-03,26,ES
5596,Live Oak,561,539,2016-05-03,22,ES
5597,McNeil,2538,2638,2016-05-03,-100,HS
5598,Old Town,679,694,2016-05-03,-15,ES
5599,Pond Springs,645,658,2016-05-03,-13,ES
5600,Purple Sage,337,341,2016-05-03,-4,ES
5601,Round Rock Opportunity Center,115,52,2016-05-03,63,Other
5602,Ridgeview,1382,1375,2016-05-03,7,MS
5603,Robertson,469,512,2016-05-03,-43,ES
5604,Round Rock,3063,3175,2016-05-03,-112,HS
5605,Sommer,1090,1016,2016-05-03,74,ES
5606,Spicewood,821,807,2016-05-03,14,ES
5607,Stony Point,2506,2570,2016-05-03,-64,HS
5608,Success,283,307,2016-05-03,-24,HS
5609,Teravista,868,923,2016-05-03,-55,ES
5610,Union Hill,811,883,2016-05-03,-72,ES
5611,Voigt,542,566,2016-05-03,-24,ES
5612,Walsh,1601,1532,2016-05-03,69,MS
5613,Wells Branch,939,939,2016-05-03,0,ES
5614,Westwood,2666,2749,2016-05-03,-83,HS
5615,Anderson Mill,524,495,2016-05-10,29,ES
5616,Berkman,497,506,2016-05-10,-9,ES
5617,Blackland Prairie,811,807,2016-05-10,4,ES
5618,Bluebonnet,567,567,2016-05-10,0,ES
5619,Brushy Creek,822,753,2016-05-10,69,ES
5620,C.D. Fulkes,701,732,2016-05-10,-31,MS
5621,Cactus Ranch,1034,1048,2016-05-10,-14,ES
5622,Caldwell Heights,679,660,2016-05-10,19,ES
5623,Callison,829,866,2016-05-10,-37,ES
5624,Canyon Creek,422,424,2016-05-10,-2,ES
5625,Canyon Vista,1406,1400,2016-05-10,6,MS
5626,Caraway,733,707,2016-05-10,26,ES
5627,Cedar Ridge,2666,2726,2016-05-10,-60,HS
5628,Cedar Valley,1368,1364,2016-05-10,4,MS
5629,Chandler Oaks,532,542,2016-05-10,-10,ES
5630,Chisholm Trail,1054,1069,2016-05-10,-15,MS
5631,Deepwood,375,404,2016-05-10,-29,ES
5632,Deerpark,895,958,2016-05-10,-63,MS
5633,Double File Trail,593,655,2016-05-10,-62,ES
5634,DAEP,8,5,2016-05-10,3,Other
5635,England,910,891,2016-05-10,19,ES
5636,Fern Bluff,658,655,2016-05-10,3,ES
5637,Forest Creek,823,837,2016-05-10,-14,ES
5638,Forest North,376,411,2016-05-10,-35,ES
5639,Gattis,761,797,2016-05-10,-36,ES
5640,Great Oaks,719,684,2016-05-10,35,ES
5641,Grisham,707,653,2016-05-10,54,MS
5642,Hernandez,790,802,2016-05-10,-12,MS
5643,Herrington,912,916,2016-05-10,-4,ES
5644,Hopewell,989,1054,2016-05-10,-65,MS
5645,JJAEP,22,29,2016-05-10,-7,Other
5646,Jollyville,463,481,2016-05-10,-18,ES
5647,Laurel Mountain,807,780,2016-05-10,27,ES
5648,Live Oak,560,539,2016-05-10,21,ES
5649,McNeil,2538,2638,2016-05-10,-100,HS
5650,Old Town,679,694,2016-05-10,-15,ES
5651,Pond Springs,645,658,2016-05-10,-13,ES
5652,Purple Sage,338,341,2016-05-10,-3,ES
5653,Round Rock Opportunity Center,128,52,2016-05-10,76,Other
5654,Ridgeview,1382,1375,2016-05-10,7,MS
5655,Robertson,469,512,2016-05-10,-43,ES
5656,Round Rock,3060,3175,2016-05-10,-115,HS
5657,Sommer,1090,1016,2016-05-10,74,ES
5658,Spicewood,821,807,2016-05-10,14,ES
5659,Stony Point,2507,2570,2016-05-10,-63,HS
5660,Success,261,307,2016-05-10,-46,HS
5661,Teravista,872,923,2016-05-10,-51,ES
5662,Union Hill,814,883,2016-05-10,-69,ES
5663,Voigt,540,566,2016-05-10,-26,ES
5664,Walsh,1599,1532,2016-05-10,67,MS
5665,Wells Branch,939,939,2016-05-10,0,ES
5666,Westwood,2661,2749,2016-05-10,-88,HS
5667,Anderson Mill,521,495,2016-05-17,26,ES
5668,Berkman,496,506,2016-05-17,-10,ES
5669,Blackland Prairie,811,807,2016-05-17,4,ES
5670,Bluebonnet,568,567,2016-05-17,1,ES
5671,Brushy Creek,824,753,2016-05-17,71,ES
5672,C.D. Fulkes,704,732,2016-05-17,-28,MS
5673,Cactus Ranch,1031,1048,2016-05-17,-17,ES
5674,Caldwell Heights,679,660,2016-05-17,19,ES
5675,Callison,828,866,2016-05-17,-38,ES
5676,Canyon Creek,422,424,2016-05-17,-2,ES
5677,Canyon Vista,1409,1400,2016-05-17,9,MS
5678,Caraway,733,707,2016-05-17,26,ES
5679,Cedar Ridge,2661,2726,2016-05-17,-65,HS
5680,Cedar Valley,1367,1364,2016-05-17,3,MS
5681,Chandler Oaks,531,542,2016-05-17,-11,ES
5682,Chisholm Trail,1055,1069,2016-05-17,-14,MS
5683,Deepwood,375,404,2016-05-17,-29,ES
5684,Deerpark,896,958,2016-05-17,-62,MS
5685,Double File Trail,594,655,2016-05-17,-61,ES
5686,DAEP,11,5,2016-05-17,6,Other
5687,England,910,891,2016-05-17,19,ES
5688,Fern Bluff,657,655,2016-05-17,2,ES
5689,Forest Creek,823,837,2016-05-17,-14,ES
5690,Forest North,376,411,2016-05-17,-35,ES
5691,Gattis,762,797,2016-05-17,-35,ES
5692,Great Oaks,715,684,2016-05-17,31,ES
5693,Grisham,707,653,2016-05-17,54,MS
5694,Hernandez,790,802,2016-05-17,-12,MS
5695,Herrington,912,916,2016-05-17,-4,ES
5696,Hopewell,987,1054,2016-05-17,-67,MS
5697,JJAEP,24,29,2016-05-17,-5,Other
5698,Jollyville,465,481,2016-05-17,-16,ES
5699,Laurel Mountain,809,780,2016-05-17,29,ES
5700,Live Oak,559,539,2016-05-17,20,ES
5701,McNeil,2534,2638,2016-05-17,-104,HS
5702,Old Town,679,694,2016-05-17,-15,ES
5703,Pond Springs,646,658,2016-05-17,-12,ES
5704,Purple Sage,338,341,2016-05-17,-3,ES
5705,Round Rock Opportunity Center,132,52,2016-05-17,80,Other
5706,Ridgeview,1382,1375,2016-05-17,7,MS
5707,Robertson,468,512,2016-05-17,-44,ES
5708,Round Rock,3058,3175,2016-05-17,-117,HS
5709,Sommer,1091,1016,2016-05-17,75,ES
5710,Spicewood,821,807,2016-05-17,14,ES
5711,Stony Point,2501,2570,2016-05-17,-69,HS
5712,Success,231,307,2016-05-17,-76,HS
5713,Teravista,871,923,2016-05-17,-52,ES
5714,Union Hill,815,883,2016-05-17,-68,ES
5715,Voigt,539,566,2016-05-17,-27,ES
5716,Walsh,1599,1532,2016-05-17,67,MS
5717,Wells Branch,938,939,2016-05-17,-1,ES
5718,Westwood,2658,2749,2016-05-17,-91,HS
5719,Anderson Mill,518,495,2016-05-24,23,ES
5720,Berkman,492,506,2016-05-24,-14,ES
5721,Blackland Prairie,811,807,2016-05-24,4,ES
5722,Bluebonnet,570,567,2016-05-24,3,ES
5723,Brushy Creek,824,753,2016-05-24,71,ES
5724,C.D. Fulkes,697,732,2016-05-24,-35,MS
5725,Cactus Ranch,1028,1048,2016-05-24,-20,ES
5726,Caldwell Heights,676,660,2016-05-24,16,ES
5727,Callison,826,866,2016-05-24,-40,ES
5728,Canyon Creek,422,424,2016-05-24,-2,ES
5729,Canyon Vista,1408,1400,2016-05-24,8,MS
5730,Caraway,735,707,2016-05-24,28,ES
5731,Cedar Ridge,2658,2726,2016-05-24,-68,HS
5732,Cedar Valley,1367,1364,2016-05-24,3,MS
5733,Chandler Oaks,531,542,2016-05-24,-11,ES
5734,Chisholm Trail,1056,1069,2016-05-24,-13,MS
5735,Deepwood,374,404,2016-05-24,-30,ES
5736,Deerpark,895,958,2016-05-24,-63,MS
5737,Double File Trail,593,655,2016-05-24,-62,ES
5738,DAEP,9,5,2016-05-24,4,Other
5739,England,912,891,2016-05-24,21,ES
5740,Fern Bluff,656,655,2016-05-24,1,ES
5741,Forest Creek,824,837,2016-05-24,-13,ES
5742,Forest North,377,411,2016-05-24,-34,ES
5743,Gattis,760,797,2016-05-24,-37,ES
5744,Great Oaks,715,684,2016-05-24,31,ES
5745,Grisham,706,653,2016-05-24,53,MS
5746,Hernandez,790,802,2016-05-24,-12,MS
5747,Herrington,912,916,2016-05-24,-4,ES
5748,Hopewell,987,1054,2016-05-24,-67,MS
5749,JJAEP,25,29,2016-05-24,-4,Other
5750,Jollyville,465,481,2016-05-24,-16,ES
5751,Laurel Mountain,809,780,2016-05-24,29,ES
5752,Live Oak,559,539,2016-05-24,20,ES
5753,McNeil,2532,2638,2016-05-24,-106,HS
5754,Old Town,679,694,2016-05-24,-15,ES
5755,Pond Springs,646,658,2016-05-24,-12,ES
5756,Purple Sage,339,341,2016-05-24,-2,ES
5757,Round Rock Opportunity Center,138,52,2016-05-24,86,Other
5758,Ridgeview,1382,1375,2016-05-24,7,MS
5759,Robertson,468,512,2016-05-24,-44,ES
5760,Round Rock,3053,3175,2016-05-24,-122,HS
5761,Sommer,1090,1016,2016-05-24,74,ES
5762,Spicewood,821,807,2016-05-24,14,ES
5763,Stony Point,2500,2570,2016-05-24,-70,HS
5764,Success,210,307,2016-05-24,-97,HS
5765,Teravista,872,923,2016-05-24,-51,ES
5766,Union Hill,816,883,2016-05-24,-67,ES
5767,Voigt,537,566,2016-05-24,-29,ES
5768,Walsh,1599,1532,2016-05-24,67,MS
5769,Wells Branch,937,939,2016-05-24,-2,ES
5770,Westwood,2657,2749,2016-05-24,-92,HS
5771,Anderson Mill,517,495,2016-06-02,22,ES
5772,Berkman,493,506,2016-06-02,-13,ES
5773,Blackland Prairie,808,807,2016-06-02,1,ES
5774,Bluebonnet,567,567,2016-06-02,0,ES
5775,Brushy Creek,822,753,2016-06-02,69,ES
5776,C.D. Fulkes,694,732,2016-06-02,-38,MS
5777,Cactus Ranch,1024,1048,2016-06-02,-24,ES
5778,Caldwell Heights,675,660,2016-06-02,15,ES
5779,Callison,822,866,2016-06-02,-44,ES
5780,Canyon Creek,422,424,2016-06-02,-2,ES
5781,Canyon Vista,1408,1400,2016-06-02,8,MS
5782,Caraway,734,707,2016-06-02,27,ES
5783,Cedar Ridge,2652,2726,2016-06-02,-74,HS
5784,Cedar Valley,1364,1364,2016-06-02,0,MS
5785,Chandler Oaks,531,542,2016-06-02,-11,ES
5786,Chisholm Trail,1056,1069,2016-06-02,-13,MS
5787,Deepwood,373,404,2016-06-02,-31,ES
5788,Deerpark,894,958,2016-06-02,-64,MS
5789,Double File Trail,593,655,2016-06-02,-62,ES
5790,DAEP,9,5,2016-06-02,4,Other
5791,England,912,891,2016-06-02,21,ES
5792,Fern Bluff,656,655,2016-06-02,1,ES
5793,Forest Creek,822,837,2016-06-02,-15,ES
5794,Forest North,378,411,2016-06-02,-33,ES
5795,Gattis,758,797,2016-06-02,-39,ES
5796,Great Oaks,715,684,2016-06-02,31,ES
5797,Grisham,704,653,2016-06-02,51,MS
5798,Hernandez,790,802,2016-06-02,-12,MS
5799,Herrington,910,916,2016-06-02,-6,ES
5800,Hopewell,986,1054,2016-06-02,-68,MS
5801,JJAEP,24,29,2016-06-02,-5,Other
5802,Jollyville,464,481,2016-06-02,-17,ES
5803,Laurel Mountain,808,780,2016-06-02,28,ES
5804,Live Oak,559,539,2016-06-02,20,ES
5805,McNeil,2531,2638,2016-06-02,-107,HS
5806,Old Town,679,694,2016-06-02,-15,ES
5807,Pond Springs,644,658,2016-06-02,-14,ES
5808,Purple Sage,336,341,2016-06-02,-5,ES
5809,Round Rock Opportunity Center,141,52,2016-06-02,89,Other
5810,Ridgeview,1382,1375,2016-06-02,7,MS
5811,Robertson,468,512,2016-06-02,-44,ES
5812,Round Rock,3048,3175,2016-06-02,-127,HS
5813,Sommer,1090,1016,2016-06-02,74,ES
5814,Spicewood,821,807,2016-06-02,14,ES
5815,Stony Point,2504,2570,2016-06-02,-66,HS
5816,Success,169,307,2016-06-02,-138,HS
5817,Teravista,869,923,2016-06-02,-54,ES
5818,Union Hill,816,883,2016-06-02,-67,ES
5819,Voigt,538,566,2016-06-02,-28,ES
5820,Walsh,1599,1532,2016-06-02,67,MS
5821,Wells Branch,937,939,2016-06-02,-2,ES
5822,Westwood,2655,2749,2016-06-02,-94,HS
5823,Anderson Mill,500,522,2016-08-23,-22,ES
5824,Berkman,449,491,2016-08-23,-42,ES
5825,Blackland Prairie,748,767,2016-08-23,-19,ES
5826,Bluebonnet,433,546,2016-08-23,-113,ES
5827,Brushy Creek,791,831,2016-08-23,-40,ES
5828,C.D. Fulkes,674,712,2016-08-23,-38,MS
5829,Cactus Ranch,982,1001,2016-08-23,-19,ES
5830,Caldwell Heights,625,671,2016-08-23,-46,ES
5831,Callison,754,805,2016-08-23,-51,ES
5832,Canyon Creek,426,412,2016-08-23,14,ES
5833,Canyon Vista,1346,1410,2016-08-23,-64,MS
5834,Caraway,722,746,2016-08-23,-24,ES
5835,Cedar Ridge,2694,2790,2016-08-23,-96,HS
5836,Cedar Valley,1434,1458,2016-08-23,-24,MS
5837,Chandler Oaks,541,495,2016-08-23,46,ES
5838,Chisholm Trail,1024,1026,2016-08-23,-2,MS
5839,Deepwood,328,355,2016-08-23,-27,ES
5840,Deerpark,896,909,2016-08-23,-13,MS
5841,Double File Trail,612,560,2016-08-23,52,ES
5842,DAEP,0,0,2016-08-23,0,Other
5843,England,927,956,2016-08-23,-29,ES
5844,Fern Bluff,625,628,2016-08-23,-3,ES
5845,Forest Creek,834,808,2016-08-23,26,ES
5846,Forest North,350,405,2016-08-23,-55,ES
5847,Gattis,657,719,2016-08-23,-62,ES
5848,Great Oaks,686,686,2016-08-23,0,ES
5849,Grisham,694,676,2016-08-23,18,MS
5850,Hernandez,767,777,2016-08-23,-10,MS
5851,Herrington,990,935,2016-08-23,55,ES
5852,Hopewell,1039,1079,2016-08-23,-40,MS
5853,JJAEP,0,11,2016-08-23,-11,Other
5854,Johnson,491,502,2016-08-23,-11,ES
5855,Jollyville,414,468,2016-08-23,-54,ES
5856,Laurel Mountain,753,811,2016-08-23,-58,ES
5857,Live Oak,530,589,2016-08-23,-59,ES
5858,McNeil,2656,2701,2016-08-23,-45,HS
5859,Old Town,774,637,2016-08-23,137,ES
5860,Pond Springs,659,620,2016-08-23,39,ES
5861,Purple Sage,377,341,2016-08-23,36,ES
5862,Round Rock Opportunity Center,51,41,2016-08-23,10,Other
5863,Ridgeview,1336,1369,2016-08-23,-33,MS
5864,Robertson,422,466,2016-08-23,-44,ES
5865,Round Rock,3170,3319,2016-08-23,-149,HS
5866,Sommer,1147,1127,2016-08-23,20,ES
5867,Spicewood,802,819,2016-08-23,-17,ES
5868,Stony Point,2607,2664,2016-08-23,-57,HS
5869,Success,312,346,2016-08-23,-34,HS
5870,Teravista,811,867,2016-08-23,-56,ES
5871,Union Hill,762,796,2016-08-23,-34,ES
5872,Voigt,535,510,2016-08-23,25,ES
5873,Walsh,1673,1657,2016-08-23,16,MS
5874,Wells Branch,478,485,2016-08-23,-7,ES
5875,Westwood,2686,2736,2016-08-23,-50,HS
5876,LOTT,2,15,2016-08-23,-13,Other
5877,Anderson Mill,513,522,2016-08-30,-9,ES
5878,Berkman,468,491,2016-08-30,-23,ES
5879,Blackland Prairie,758,767,2016-08-30,-9,ES
5880,Bluebonnet,442,546,2016-08-30,-104,ES
5881,Brushy Creek,798,831,2016-08-30,-33,ES
5882,C.D. Fulkes,684,712,2016-08-30,-28,MS
5883,Cactus Ranch,992,1001,2016-08-30,-9,ES
5884,Caldwell Heights,633,671,2016-08-30,-38,ES
5885,Callison,777,805,2016-08-30,-28,ES
5886,Canyon Creek,427,412,2016-08-30,15,ES
5887,Canyon Vista,1356,1410,2016-08-30,-54,MS
5888,Caraway,739,746,2016-08-30,-7,ES
5889,Cedar Ridge,2741,2790,2016-08-30,-49,HS
5890,Cedar Valley,1441,1458,2016-08-30,-17,MS
5891,Chandler Oaks,543,495,2016-08-30,48,ES
5892,Chisholm Trail,1036,1026,2016-08-30,10,MS
5893,Deepwood,336,355,2016-08-30,-19,ES
5894,Deerpark,917,909,2016-08-30,8,MS
5895,Double File Trail,622,560,2016-08-30,62,ES
5896,DAEP,0,0,2016-08-30,0,Other
5897,England,957,956,2016-08-30,1,ES
5898,Fern Bluff,627,628,2016-08-30,-1,ES
5899,Forest Creek,844,808,2016-08-30,36,ES
5900,Forest North,358,405,2016-08-30,-47,ES
5901,Gattis,681,719,2016-08-30,-38,ES
5902,Great Oaks,692,686,2016-08-30,6,ES
5903,Grisham,707,676,2016-08-30,31,MS
5904,Hernandez,800,777,2016-08-30,23,MS
5905,Herrington,999,935,2016-08-30,64,ES
5906,Hopewell,1057,1079,2016-08-30,-22,MS
5907,JJAEP,6,11,2016-08-30,-5,Other
5908,Johnson,487,502,2016-08-30,-15,ES
5909,Jollyville,426,468,2016-08-30,-42,ES
5910,Laurel Mountain,767,811,2016-08-30,-44,ES
5911,Live Oak,550,589,2016-08-30,-39,ES
5912,McNeil,2685,2701,2016-08-30,-16,HS
5913,Old Town,796,637,2016-08-30,159,ES
5914,Pond Springs,670,620,2016-08-30,50,ES
5915,Purple Sage,384,341,2016-08-30,43,ES
5916,Round Rock Opportunity Center,64,41,2016-08-30,23,Other
5917,Ridgeview,1352,1369,2016-08-30,-17,MS
5918,Robertson,433,466,2016-08-30,-33,ES
5919,Round Rock,3219,3319,2016-08-30,-100,HS
5920,Sommer,1167,1127,2016-08-30,40,ES
5921,Spicewood,818,819,2016-08-30,-1,ES
5922,Stony Point,2643,2664,2016-08-30,-21,HS
5923,Success,329,346,2016-08-30,-17,HS
5924,Teravista,830,867,2016-08-30,-37,ES
5925,Union Hill,774,796,2016-08-30,-22,ES
5926,Voigt,551,510,2016-08-30,41,ES
5927,Walsh,1684,1657,2016-08-30,27,MS
5928,Wells Branch,490,485,2016-08-30,5,ES
5929,Westwood,2683,2736,2016-08-30,-53,HS
5930,LOTT,12,15,2016-08-30,-3,Other
5931,Anderson Mill,512,522,2016-09-06,-10,ES
5932,Berkman,473,491,2016-09-06,-18,ES
5933,Blackland Prairie,760,767,2016-09-06,-7,ES
5934,Bluebonnet,443,546,2016-09-06,-103,ES
5935,Brushy Creek,802,831,2016-09-06,-29,ES
5936,C.D. Fulkes,686,712,2016-09-06,-26,MS
5937,Cactus Ranch,995,1001,2016-09-06,-6,ES
5938,Caldwell Heights,633,671,2016-09-06,-38,ES
5939,Callison,777,805,2016-09-06,-28,ES
5940,Canyon Creek,427,412,2016-09-06,15,ES
5941,Canyon Vista,1358,1410,2016-09-06,-52,MS
5942,Caraway,746,746,2016-09-06,0,ES
5943,Cedar Ridge,2748,2790,2016-09-06,-42,HS
5944,Cedar Valley,1443,1458,2016-09-06,-15,MS
5945,Chandler Oaks,545,495,2016-09-06,50,ES
5946,Chisholm Trail,1033,1026,2016-09-06,7,MS
5947,Deepwood,337,355,2016-09-06,-18,ES
5948,Deerpark,917,909,2016-09-06,8,MS
5949,Double File Trail,630,560,2016-09-06,70,ES
5950,DAEP,0,0,2016-09-06,0,Other
5951,England,964,956,2016-09-06,8,ES
5952,Fern Bluff,628,628,2016-09-06,0,ES
5953,Forest Creek,846,808,2016-09-06,38,ES
5954,Forest North,361,405,2016-09-06,-44,ES
5955,Gattis,683,719,2016-09-06,-36,ES
5956,Great Oaks,690,686,2016-09-06,4,ES
5957,Grisham,708,676,2016-09-06,32,MS
5958,Hernandez,803,777,2016-09-06,26,MS
5959,Herrington,997,935,2016-09-06,62,ES
5960,Hopewell,1058,1079,2016-09-06,-21,MS
5961,JJAEP,6,11,2016-09-06,-5,Other
5962,Johnson,491,502,2016-09-06,-11,ES
5963,Jollyville,431,468,2016-09-06,-37,ES
5964,Laurel Mountain,771,811,2016-09-06,-40,ES
5965,Live Oak,557,589,2016-09-06,-32,ES
5966,McNeil,2686,2701,2016-09-06,-15,HS
5967,Old Town,797,637,2016-09-06,160,ES
5968,Pond Springs,667,620,2016-09-06,47,ES
5969,Purple Sage,386,341,2016-09-06,45,ES
5970,Round Rock Opportunity Center,68,41,2016-09-06,27,Other
5971,Ridgeview,1352,1369,2016-09-06,-17,MS
5972,Robertson,436,466,2016-09-06,-30,ES
5973,Round Rock,3218,3319,2016-09-06,-101,HS
5974,Sommer,1172,1127,2016-09-06,45,ES
5975,Spicewood,819,819,2016-09-06,0,ES
5976,Stony Point,2641,2664,2016-09-06,-23,HS
5977,Success,331,346,2016-09-06,-15,HS
5978,Teravista,832,867,2016-09-06,-35,ES
5979,Union Hill,773,796,2016-09-06,-23,ES
5980,Voigt,546,510,2016-09-06,36,ES
5981,Walsh,1685,1657,2016-09-06,28,MS
5982,Wells Branch,492,485,2016-09-06,7,ES
5983,Westwood,2687,2736,2016-09-06,-49,HS
5984,LOTT,12,15,2016-09-06,-3,Other
5985,Anderson Mill,510,522,2016-09-13,-12,ES
5986,Berkman,473,491,2016-09-13,-18,ES
5987,Blackland Prairie,762,767,2016-09-13,-5,ES
5988,Bluebonnet,446,546,2016-09-13,-100,ES
5989,Brushy Creek,804,831,2016-09-13,-27,ES
5990,C.D. Fulkes,686,712,2016-09-13,-26,MS
5991,Cactus Ranch,997,1001,2016-09-13,-4,ES
5992,Caldwell Heights,633,671,2016-09-13,-38,ES
5993,Callison,792,805,2016-09-13,-13,ES
5994,Canyon Creek,429,412,2016-09-13,17,ES
5995,Canyon Vista,1363,1410,2016-09-13,-47,MS
5996,Caraway,751,746,2016-09-13,5,ES
5997,Cedar Ridge,2753,2790,2016-09-13,-37,HS
5998,Cedar Valley,1445,1458,2016-09-13,-13,MS
5999,Chandler Oaks,545,495,2016-09-13,50,ES
6000,Chisholm Trail,1034,1026,2016-09-13,8,MS
6001,Deepwood,337,355,2016-09-13,-18,ES
6002,Deerpark,922,909,2016-09-13,13,MS
6003,Double File Trail,635,560,2016-09-13,75,ES
6004,DAEP,2,0,2016-09-13,2,Other
6005,England,967,956,2016-09-13,11,ES
6006,Fern Bluff,629,628,2016-09-13,1,ES
6007,Forest Creek,847,808,2016-09-13,39,ES
6008,Forest North,363,405,2016-09-13,-42,ES
6009,Gattis,683,719,2016-09-13,-36,ES
6010,Great Oaks,693,686,2016-09-13,7,ES
6011,Grisham,709,676,2016-09-13,33,MS
6012,Hernandez,808,777,2016-09-13,31,MS
6013,Herrington,999,935,2016-09-13,64,ES
6014,Hopewell,1064,1079,2016-09-13,-15,MS
6015,JJAEP,6,11,2016-09-13,-5,Other
6016,Johnson,499,502,2016-09-13,-3,ES
6017,Jollyville,428,468,2016-09-13,-40,ES
6018,Laurel Mountain,775,811,2016-09-13,-36,ES
6019,Live Oak,557,589,2016-09-13,-32,ES
6020,McNeil,2689,2701,2016-09-13,-12,HS
6021,Old Town,798,637,2016-09-13,161,ES
6022,Pond Springs,671,620,2016-09-13,51,ES
6023,Purple Sage,386,341,2016-09-13,45,ES
6024,Round Rock Opportunity Center,72,41,2016-09-13,31,Other
6025,Ridgeview,1354,1369,2016-09-13,-15,MS
6026,Robertson,431,466,2016-09-13,-35,ES
6027,Round Rock,3216,3319,2016-09-13,-103,HS
6028,Sommer,1174,1127,2016-09-13,47,ES
6029,Spicewood,820,819,2016-09-13,1,ES
6030,Stony Point,2640,2664,2016-09-13,-24,HS
6031,Success,339,346,2016-09-13,-7,HS
6032,Teravista,832,867,2016-09-13,-35,ES
6033,Union Hill,782,796,2016-09-13,-14,ES
6034,Voigt,548,510,2016-09-13,38,ES
6035,Walsh,1683,1657,2016-09-13,26,MS
6036,Wells Branch,495,485,2016-09-13,10,ES
6037,Westwood,2687,2736,2016-09-13,-49,HS
6038,LOTT,11,15,2016-09-13,-4,Other
6039,Anderson Mill,509,522,2016-09-20,-13,ES
6040,Berkman,469,491,2016-09-20,-22,ES
6041,Blackland Prairie,768,767,2016-09-20,1,ES
6042,Bluebonnet,447,546,2016-09-20,-99,ES
6043,Brushy Creek,804,831,2016-09-20,-27,ES
6044,C.D. Fulkes,688,712,2016-09-20,-24,MS
6045,Cactus Ranch,996,1001,2016-09-20,-5,ES
6046,Caldwell Heights,631,671,2016-09-20,-40,ES
6047,Callison,794,805,2016-09-20,-11,ES
6048,Canyon Creek,430,412,2016-09-20,18,ES
6049,Canyon Vista,1361,1410,2016-09-20,-49,MS
6050,Caraway,753,746,2016-09-20,7,ES
6051,Cedar Ridge,2758,2790,2016-09-20,-32,HS
6052,Cedar Valley,1450,1458,2016-09-20,-8,MS
6053,Chandler Oaks,545,495,2016-09-20,50,ES
6054,Chisholm Trail,1032,1026,2016-09-20,6,MS
6055,Deepwood,339,355,2016-09-20,-16,ES
6056,Deerpark,920,909,2016-09-20,11,MS
6057,Double File Trail,636,560,2016-09-20,76,ES
6058,DAEP,3,0,2016-09-20,3,Other
6059,England,967,956,2016-09-20,11,ES
6060,Fern Bluff,630,628,2016-09-20,2,ES
6061,Forest Creek,850,808,2016-09-20,42,ES
6062,Forest North,361,405,2016-09-20,-44,ES
6063,Gattis,683,719,2016-09-20,-36,ES
6064,Great Oaks,691,686,2016-09-20,5,ES
6065,Grisham,708,676,2016-09-20,32,MS
6066,Hernandez,809,777,2016-09-20,32,MS
6067,Herrington,998,935,2016-09-20,63,ES
6068,Hopewell,1063,1079,2016-09-20,-16,MS
6069,JJAEP,8,11,2016-09-20,-3,Other
6070,Johnson,498,502,2016-09-20,-4,ES
6071,Jollyville,430,468,2016-09-20,-38,ES
6072,Laurel Mountain,779,811,2016-09-20,-32,ES
6073,Live Oak,561,589,2016-09-20,-28,ES
6074,McNeil,2677,2701,2016-09-20,-24,HS
6075,Old Town,797,637,2016-09-20,160,ES
6076,Pond Springs,668,620,2016-09-20,48,ES
6077,Purple Sage,384,341,2016-09-20,43,ES
6078,Round Rock Opportunity Center,75,41,2016-09-20,34,Other
6079,Ridgeview,1358,1369,2016-09-20,-11,MS
6080,Robertson,427,466,2016-09-20,-39,ES
6081,Round Rock,3214,3319,2016-09-20,-105,HS
6082,Sommer,1173,1127,2016-09-20,46,ES
6083,Spicewood,820,819,2016-09-20,1,ES
6084,Stony Point,2640,2664,2016-09-20,-24,HS
6085,Success,344,346,2016-09-20,-2,HS
6086,Teravista,830,867,2016-09-20,-37,ES
6087,Union Hill,785,796,2016-09-20,-11,ES
6088,Voigt,558,510,2016-09-20,48,ES
6089,Walsh,1683,1657,2016-09-20,26,MS
6090,Wells Branch,497,485,2016-09-20,12,ES
6091,Westwood,2686,2736,2016-09-20,-50,HS
6092,LOTT,12,15,2016-09-20,-3,Other
6093,Anderson Mill,512,522,2016-09-27,-10,ES
6094,Berkman,472,491,2016-09-27,-19,ES
6095,Blackland Prairie,768,767,2016-09-27,1,ES
6096,Bluebonnet,446,546,2016-09-27,-100,ES
6097,Brushy Creek,802,831,2016-09-27,-29,ES
6098,C.D. Fulkes,691,712,2016-09-27,-21,MS
6099,Cactus Ranch,997,1001,2016-09-27,-4,ES
6100,Caldwell Heights,637,671,2016-09-27,-34,ES
6101,Callison,794,805,2016-09-27,-11,ES
6102,Canyon Creek,429,412,2016-09-27,17,ES
6103,Canyon Vista,1361,1410,2016-09-27,-49,MS
6104,Caraway,753,746,2016-09-27,7,ES
6105,Cedar Ridge,2759,2790,2016-09-27,-31,HS
6106,Cedar Valley,1450,1458,2016-09-27,-8,MS
6107,Chandler Oaks,544,495,2016-09-27,49,ES
6108,Chisholm Trail,1033,1026,2016-09-27,7,MS
6109,Deepwood,339,355,2016-09-27,-16,ES
6110,Deerpark,921,909,2016-09-27,12,MS
6111,Double File Trail,642,560,2016-09-27,82,ES
6112,DAEP,4,0,2016-09-27,4,Other
6113,England,965,956,2016-09-27,9,ES
6114,Fern Bluff,629,628,2016-09-27,1,ES
6115,Forest Creek,845,808,2016-09-27,37,ES
6116,Forest North,362,405,2016-09-27,-43,ES
6117,Gattis,683,719,2016-09-27,-36,ES
6118,Great Oaks,691,686,2016-09-27,5,ES
6119,Grisham,707,676,2016-09-27,31,MS
6120,Hernandez,807,777,2016-09-27,30,MS
6121,Herrington,995,935,2016-09-27,60,ES
6122,Hopewell,1060,1079,2016-09-27,-19,MS
6123,JJAEP,10,11,2016-09-27,-1,Other
6124,Johnson,506,502,2016-09-27,4,ES
6125,Jollyville,434,468,2016-09-27,-34,ES
6126,Laurel Mountain,780,811,2016-09-27,-31,ES
6127,Live Oak,563,589,2016-09-27,-26,ES
6128,McNeil,2671,2701,2016-09-27,-30,HS
6129,Old Town,801,637,2016-09-27,164,ES
6130,Pond Springs,667,620,2016-09-27,47,ES
6131,Purple Sage,384,341,2016-09-27,43,ES
6132,Round Rock Opportunity Center,77,41,2016-09-27,36,Other
6133,Ridgeview,1360,1369,2016-09-27,-9,MS
6134,Robertson,427,466,2016-09-27,-39,ES
6135,Round Rock,3212,3319,2016-09-27,-107,HS
6136,Sommer,1176,1127,2016-09-27,49,ES
6137,Spicewood,821,819,2016-09-27,2,ES
6138,Stony Point,2639,2664,2016-09-27,-25,HS
6139,Success,346,346,2016-09-27,0,HS
6140,Teravista,829,867,2016-09-27,-38,ES
6141,Union Hill,780,796,2016-09-27,-16,ES
6142,Voigt,560,510,2016-09-27,50,ES
6143,Walsh,1682,1657,2016-09-27,25,MS
6144,Wells Branch,501,485,2016-09-27,16,ES
6145,Westwood,2686,2736,2016-09-27,-50,HS
6146,LOTT,11,15,2016-09-27,-4,Other
6147,Anderson Mill,509,522,2016-10-04,-13,ES
6148,Berkman,472,491,2016-10-04,-19,ES
6149,Blackland Prairie,765,767,2016-10-04,-2,ES
6150,Bluebonnet,442,546,2016-10-04,-104,ES
6151,Brushy Creek,802,831,2016-10-04,-29,ES
6152,C.D. Fulkes,693,712,2016-10-04,-19,MS
6153,Cactus Ranch,996,1001,2016-10-04,-5,ES
6154,Caldwell Heights,637,671,2016-10-04,-34,ES
6155,Callison,793,805,2016-10-04,-12,ES
6156,Canyon Creek,429,412,2016-10-04,17,ES
6157,Canyon Vista,1364,1410,2016-10-04,-46,MS
6158,Caraway,755,746,2016-10-04,9,ES
6159,Cedar Ridge,2744,2790,2016-10-04,-46,HS
6160,Cedar Valley,1445,1458,2016-10-04,-13,MS
6161,Chandler Oaks,544,495,2016-10-04,49,ES
6162,Chisholm Trail,1035,1026,2016-10-04,9,MS
6163,Deepwood,340,355,2016-10-04,-15,ES
6164,Deerpark,926,909,2016-10-04,17,MS
6165,Double File Trail,645,560,2016-10-04,85,ES
6166,DAEP,6,0,2016-10-04,6,Other
6167,England,964,956,2016-10-04,8,ES
6168,Fern Bluff,630,628,2016-10-04,2,ES
6169,Forest Creek,845,808,2016-10-04,37,ES
6170,Forest North,367,405,2016-10-04,-38,ES
6171,Gattis,683,719,2016-10-04,-36,ES
6172,Great Oaks,696,686,2016-10-04,10,ES
6173,Grisham,708,676,2016-10-04,32,MS
6174,Hernandez,806,777,2016-10-04,29,MS
6175,Herrington,992,935,2016-10-04,57,ES
6176,Hopewell,1063,1079,2016-10-04,-16,MS
6177,JJAEP,9,11,2016-10-04,-2,Other
6178,Johnson,510,502,2016-10-04,8,ES
6179,Jollyville,431,468,2016-10-04,-37,ES
6180,Laurel Mountain,782,811,2016-10-04,-29,ES
6181,Live Oak,563,589,2016-10-04,-26,ES
6182,McNeil,2663,2701,2016-10-04,-38,HS
6183,Old Town,799,637,2016-10-04,162,ES
6184,Pond Springs,663,620,2016-10-04,43,ES
6185,Purple Sage,387,341,2016-10-04,46,ES
6186,Round Rock Opportunity Center,91,41,2016-10-04,50,Other
6187,Ridgeview,1359,1369,2016-10-04,-10,MS
6188,Robertson,432,466,2016-10-04,-34,ES
6189,Round Rock,3206,3319,2016-10-04,-113,HS
6190,Sommer,1175,1127,2016-10-04,48,ES
6191,Spicewood,823,819,2016-10-04,4,ES
6192,Stony Point,2639,2664,2016-10-04,-25,HS
6193,Success,344,346,2016-10-04,-2,HS
6194,Teravista,832,867,2016-10-04,-35,ES
6195,Union Hill,776,796,2016-10-04,-20,ES
6196,Voigt,563,510,2016-10-04,53,ES
6197,Walsh,1686,1657,2016-10-04,29,MS
6198,Wells Branch,498,485,2016-10-04,13,ES
6199,Westwood,2684,2736,2016-10-04,-52,HS
6200,LOTT,11,15,2016-10-04,-4,Other
6201,Anderson Mill,504,522,2016-10-11,-18,ES
6202,Berkman,471,491,2016-10-11,-20,ES
6203,Blackland Prairie,767,767,2016-10-11,0,ES
6204,Bluebonnet,443,546,2016-10-11,-103,ES
6205,Brushy Creek,804,831,2016-10-11,-27,ES
6206,C.D. Fulkes,693,712,2016-10-11,-19,MS
6207,Cactus Ranch,996,1001,2016-10-11,-5,ES
6208,Caldwell Heights,638,671,2016-10-11,-33,ES
6209,Callison,795,805,2016-10-11,-10,ES
6210,Canyon Creek,429,412,2016-10-11,17,ES
6211,Canyon Vista,1365,1410,2016-10-11,-45,MS
6212,Caraway,756,746,2016-10-11,10,ES
6213,Cedar Ridge,2736,2790,2016-10-11,-54,HS
6214,Cedar Valley,1444,1458,2016-10-11,-14,MS
6215,Chandler Oaks,545,495,2016-10-11,50,ES
6216,Chisholm Trail,1038,1026,2016-10-11,12,MS
6217,Deepwood,340,355,2016-10-11,-15,ES
6218,Deerpark,924,909,2016-10-11,15,MS
6219,Double File Trail,648,560,2016-10-11,88,ES
6220,DAEP,8,0,2016-10-11,8,Other
6221,England,967,956,2016-10-11,11,ES
6222,Fern Bluff,630,628,2016-10-11,2,ES
6223,Forest Creek,850,808,2016-10-11,42,ES
6224,Forest North,367,405,2016-10-11,-38,ES
6225,Gattis,687,719,2016-10-11,-32,ES
6226,Great Oaks,696,686,2016-10-11,10,ES
6227,Grisham,707,676,2016-10-11,31,MS
6228,Hernandez,806,777,2016-10-11,29,MS
6229,Herrington,992,935,2016-10-11,57,ES
6230,Hopewell,1061,1079,2016-10-11,-18,MS
6231,JJAEP,10,11,2016-10-11,-1,Other
6232,Johnson,514,502,2016-10-11,12,ES
6233,Jollyville,429,468,2016-10-11,-39,ES
6234,Laurel Mountain,784,811,2016-10-11,-27,ES
6235,Live Oak,561,589,2016-10-11,-28,ES
6236,McNeil,2652,2701,2016-10-11,-49,HS
6237,Old Town,798,637,2016-10-11,161,ES
6238,Pond Springs,668,620,2016-10-11,48,ES
6239,Purple Sage,389,341,2016-10-11,48,ES
6240,Round Rock Opportunity Center,97,41,2016-10-11,56,Other
6241,Ridgeview,1362,1369,2016-10-11,-7,MS
6242,Robertson,430,466,2016-10-11,-36,ES
6243,Round Rock,3203,3319,2016-10-11,-116,HS
6244,Sommer,1175,1127,2016-10-11,48,ES
6245,Spicewood,823,819,2016-10-11,4,ES
6246,Stony Point,2633,2664,2016-10-11,-31,HS
6247,Success,345,346,2016-10-11,-1,HS
6248,Teravista,835,867,2016-10-11,-32,ES
6249,Union Hill,774,796,2016-10-11,-22,ES
6250,Voigt,563,510,2016-10-11,53,ES
6251,Walsh,1687,1657,2016-10-11,30,MS
6252,Wells Branch,499,485,2016-10-11,14,ES
6253,Westwood,2675,2736,2016-10-11,-61,HS
6254,LOTT,12,15,2016-10-11,-3,Other
6255,Anderson Mill,500,522,2016-10-18,-22,ES
6256,Berkman,471,491,2016-10-18,-20,ES
6257,Blackland Prairie,768,767,2016-10-18,1,ES
6258,Bluebonnet,441,546,2016-10-18,-105,ES
6259,Brushy Creek,802,831,2016-10-18,-29,ES
6260,C.D. Fulkes,694,712,2016-10-18,-18,MS
6261,Cactus Ranch,999,1001,2016-10-18,-2,ES
6262,Caldwell Heights,632,671,2016-10-18,-39,ES
6263,Callison,793,805,2016-10-18,-12,ES
6264,Canyon Creek,428,412,2016-10-18,16,ES
6265,Canyon Vista,1365,1410,2016-10-18,-45,MS
6266,Caraway,756,746,2016-10-18,10,ES
6267,Cedar Ridge,2727,2790,2016-10-18,-63,HS
6268,Cedar Valley,1444,1458,2016-10-18,-14,MS
6269,Chandler Oaks,549,495,2016-10-18,54,ES
6270,Chisholm Trail,1032,1026,2016-10-18,6,MS
6271,Deepwood,339,355,2016-10-18,-16,ES
6272,Deerpark,917,909,2016-10-18,8,MS
6273,Double File Trail,648,560,2016-10-18,88,ES
6274,DAEP,7,0,2016-10-18,7,Other
6275,England,969,956,2016-10-18,13,ES
6276,Fern Bluff,631,628,2016-10-18,3,ES
6277,Forest Creek,854,808,2016-10-18,46,ES
6278,Forest North,367,405,2016-10-18,-38,ES
6279,Gattis,689,719,2016-10-18,-30,ES
6280,Great Oaks,696,686,2016-10-18,10,ES
6281,Grisham,705,676,2016-10-18,29,MS
6282,Hernandez,806,777,2016-10-18,29,MS
6283,Herrington,996,935,2016-10-18,61,ES
6284,Hopewell,1059,1079,2016-10-18,-20,MS
6285,JJAEP,10,11,2016-10-18,-1,Other
6286,Johnson,513,502,2016-10-18,11,ES
6287,Jollyville,434,468,2016-10-18,-34,ES
6288,Laurel Mountain,786,811,2016-10-18,-25,ES
6289,Live Oak,559,589,2016-10-18,-30,ES
6290,McNeil,2646,2701,2016-10-18,-55,HS
6291,Old Town,798,637,2016-10-18,161,ES
6292,Pond Springs,670,620,2016-10-18,50,ES
6293,Purple Sage,389,341,2016-10-18,48,ES
6294,Round Rock Opportunity Center,110,41,2016-10-18,69,Other
6295,Ridgeview,1363,1369,2016-10-18,-6,MS
6296,Robertson,437,466,2016-10-18,-29,ES
6297,Round Rock,3199,3319,2016-10-18,-120,HS
6298,Sommer,1176,1127,2016-10-18,49,ES
6299,Spicewood,825,819,2016-10-18,6,ES
6300,Stony Point,2632,2664,2016-10-18,-32,HS
6301,Success,351,346,2016-10-18,5,HS
6302,Teravista,834,867,2016-10-18,-33,ES
6303,Union Hill,774,796,2016-10-18,-22,ES
6304,Voigt,566,510,2016-10-18,56,ES
6305,Walsh,1691,1657,2016-10-18,34,MS
6306,Wells Branch,502,485,2016-10-18,17,ES
6307,Westwood,2677,2736,2016-10-18,-59,HS
6308,LOTT,12,15,2016-10-18,-3,Other
6309,Anderson Mill,501,522,2016-10-25,-21,ES
6310,Berkman,476,491,2016-10-25,-15,ES
6311,Blackland Prairie,768,767,2016-10-25,1,ES
6312,Bluebonnet,439,546,2016-10-25,-107,ES
6313,Brushy Creek,801,831,2016-10-25,-30,ES
6314,C.D. Fulkes,693,712,2016-10-25,-19,MS
6315,Cactus Ranch,1001,1001,2016-10-25,0,ES
6316,Caldwell Heights,635,671,2016-10-25,-36,ES
6317,Callison,798,805,2016-10-25,-7,ES
6318,Canyon Creek,428,412,2016-10-25,16,ES
6319,Canyon Vista,1369,1410,2016-10-25,-41,MS
6320,Caraway,760,746,2016-10-25,14,ES
6321,Cedar Ridge,2723,2790,2016-10-25,-67,HS
6322,Cedar Valley,1443,1458,2016-10-25,-15,MS
6323,Chandler Oaks,549,495,2016-10-25,54,ES
6324,Chisholm Trail,1037,1026,2016-10-25,11,MS
6325,Deepwood,339,355,2016-10-25,-16,ES
6326,Deerpark,918,909,2016-10-25,9,MS
6327,Double File Trail,648,560,2016-10-25,88,ES
6328,DAEP,8,0,2016-10-25,8,Other
6329,England,971,956,2016-10-25,15,ES
6330,Fern Bluff,630,628,2016-10-25,2,ES
6331,Forest Creek,853,808,2016-10-25,45,ES
6332,Forest North,364,405,2016-10-25,-41,ES
6333,Gattis,690,719,2016-10-25,-29,ES
6334,Great Oaks,698,686,2016-10-25,12,ES
6335,Grisham,704,676,2016-10-25,28,MS
6336,Hernandez,805,777,2016-10-25,28,MS
6337,Herrington,997,935,2016-10-25,62,ES
6338,Hopewell,1059,1079,2016-10-25,-20,MS
6339,JJAEP,9,11,2016-10-25,-2,Other
6340,Johnson,523,502,2016-10-25,21,ES
6341,Jollyville,431,468,2016-10-25,-37,ES
6342,Laurel Mountain,786,811,2016-10-25,-25,ES
6343,Live Oak,563,589,2016-10-25,-26,ES
6344,McNeil,2642,2701,2016-10-25,-59,HS
6345,Old Town,796,637,2016-10-25,159,ES
6346,Pond Springs,670,620,2016-10-25,50,ES
6347,Purple Sage,389,341,2016-10-25,48,ES
6348,Round Rock Opportunity Center,114,41,2016-10-25,73,Other
6349,Ridgeview,1362,1369,2016-10-25,-7,MS
6350,Robertson,440,466,2016-10-25,-26,ES
6351,Round Rock,3201,3319,2016-10-25,-118,HS
6352,Sommer,1177,1127,2016-10-25,50,ES
6353,Spicewood,825,819,2016-10-25,6,ES
6354,Stony Point,2627,2664,2016-10-25,-37,HS
6355,Success,349,346,2016-10-25,3,HS
6356,Teravista,836,867,2016-10-25,-31,ES
6357,Union Hill,776,796,2016-10-25,-20,ES
6358,Voigt,566,510,2016-10-25,56,ES
6359,Walsh,1690,1657,2016-10-25,33,MS
6360,Wells Branch,500,485,2016-10-25,15,ES
6361,Westwood,2677,2736,2016-10-25,-59,HS
6362,LOTT,14,15,2016-10-25,-1,Other
6363,Anderson Mill,501,522,2016-11-01,-21,ES
6364,Berkman,476,491,2016-11-01,-15,ES
6365,Blackland Prairie,773,767,2016-11-01,6,ES
6366,Bluebonnet,437,546,2016-11-01,-109,ES
6367,Brushy Creek,803,831,2016-11-01,-28,ES
6368,C.D. Fulkes,690,712,2016-11-01,-22,MS
6369,Cactus Ranch,998,1001,2016-11-01,-3,ES
6370,Caldwell Heights,635,671,2016-11-01,-36,ES
6371,Callison,796,805,2016-11-01,-9,ES
6372,Canyon Creek,428,412,2016-11-01,16,ES
6373,Canyon Vista,1370,1410,2016-11-01,-40,MS
6374,Caraway,758,746,2016-11-01,12,ES
6375,Cedar Ridge,2717,2790,2016-11-01,-73,HS
6376,Cedar Valley,1444,1458,2016-11-01,-14,MS
6377,Chandler Oaks,547,495,2016-11-01,52,ES
6378,Chisholm Trail,1037,1026,2016-11-01,11,MS
6379,Deepwood,339,355,2016-11-01,-16,ES
6380,Deerpark,920,909,2016-11-01,11,MS
6381,Double File Trail,646,560,2016-11-01,86,ES
6382,DAEP,7,0,2016-11-01,7,Other
6383,England,968,956,2016-11-01,12,ES
6384,Fern Bluff,630,628,2016-11-01,2,ES
6385,Forest Creek,854,808,2016-11-01,46,ES
6386,Forest North,362,405,2016-11-01,-43,ES
6387,Gattis,690,719,2016-11-01,-29,ES
6388,Great Oaks,696,686,2016-11-01,10,ES
6389,Grisham,700,676,2016-11-01,24,MS
6390,Hernandez,804,777,2016-11-01,27,MS
6391,Herrington,997,935,2016-11-01,62,ES
6392,Hopewell,1057,1079,2016-11-01,-22,MS
6393,JJAEP,8,11,2016-11-01,-3,Other
6394,Johnson,518,502,2016-11-01,16,ES
6395,Jollyville,434,468,2016-11-01,-34,ES
6396,Laurel Mountain,786,811,2016-11-01,-25,ES
6397,Live Oak,560,589,2016-11-01,-29,ES
6398,McNeil,2643,2701,2016-11-01,-58,HS
6399,Old Town,796,637,2016-11-01,159,ES
6400,Pond Springs,668,620,2016-11-01,48,ES
6401,Purple Sage,388,341,2016-11-01,47,ES
6402,Round Rock Opportunity Center,112,41,2016-11-01,71,Other
6403,Ridgeview,1363,1369,2016-11-01,-6,MS
6404,Robertson,443,466,2016-11-01,-23,ES
6405,Round Rock,3203,3319,2016-11-01,-116,HS
6406,Sommer,1174,1127,2016-11-01,47,ES
6407,Spicewood,826,819,2016-11-01,7,ES
6408,Stony Point,2627,2664,2016-11-01,-37,HS
6409,Success,343,346,2016-11-01,-3,HS
6410,Teravista,835,867,2016-11-01,-32,ES
6411,Union Hill,773,796,2016-11-01,-23,ES
6412,Voigt,566,510,2016-11-01,56,ES
6413,Walsh,1686,1657,2016-11-01,29,MS
6414,Wells Branch,498,485,2016-11-01,13,ES
6415,Westwood,2677,2736,2016-11-01,-59,HS
6416,LOTT,15,15,2016-11-01,0,Other
6417,Anderson Mill,499,522,2016-11-08,-23,ES
6418,Berkman,471,491,2016-11-08,-20,ES
6419,Blackland Prairie,773,767,2016-11-08,6,ES
6420,Bluebonnet,434,546,2016-11-08,-112,ES
6421,Brushy Creek,807,831,2016-11-08,-24,ES
6422,C.D. Fulkes,690,712,2016-11-08,-22,MS
6423,Cactus Ranch,998,1001,2016-11-08,-3,ES
6424,Caldwell Heights,637,671,2016-11-08,-34,ES
6425,Callison,796,805,2016-11-08,-9,ES
6426,Canyon Creek,426,412,2016-11-08,14,ES
6427,Canyon Vista,1372,1410,2016-11-08,-38,MS
6428,Caraway,763,746,2016-11-08,17,ES
6429,Cedar Ridge,2722,2790,2016-11-08,-68,HS
6430,Cedar Valley,1446,1458,2016-11-08,-12,MS
6431,Chandler Oaks,549,495,2016-11-08,54,ES
6432,Chisholm Trail,1041,1026,2016-11-08,15,MS
6433,Deepwood,340,355,2016-11-08,-15,ES
6434,Deerpark,916,909,2016-11-08,7,MS
6435,Double File Trail,652,560,2016-11-08,92,ES
6436,DAEP,6,0,2016-11-08,6,Other
6437,England,967,956,2016-11-08,11,ES
6438,Fern Bluff,633,628,2016-11-08,5,ES
6439,Forest Creek,852,808,2016-11-08,44,ES
6440,Forest North,361,405,2016-11-08,-44,ES
6441,Gattis,693,719,2016-11-08,-26,ES
6442,Great Oaks,696,686,2016-11-08,10,ES
6443,Grisham,704,676,2016-11-08,28,MS
6444,Hernandez,801,777,2016-11-08,24,MS
6445,Herrington,996,935,2016-11-08,61,ES
6446,Hopewell,1059,1079,2016-11-08,-20,MS
6447,JJAEP,7,11,2016-11-08,-4,Other
6448,Johnson,517,502,2016-11-08,15,ES
6449,Jollyville,434,468,2016-11-08,-34,ES
6450,Laurel Mountain,786,811,2016-11-08,-25,ES
6451,Live Oak,558,589,2016-11-08,-31,ES
6452,McNeil,2639,2701,2016-11-08,-62,HS
6453,Old Town,799,637,2016-11-08,162,ES
6454,Pond Springs,667,620,2016-11-08,47,ES
6455,Purple Sage,390,341,2016-11-08,49,ES
6456,Round Rock Opportunity Center,119,41,2016-11-08,78,Other
6457,Ridgeview,1362,1369,2016-11-08,-7,MS
6458,Robertson,450,466,2016-11-08,-16,ES
6459,Round Rock,3202,3319,2016-11-08,-117,HS
6460,Sommer,1177,1127,2016-11-08,50,ES
6461,Spicewood,826,819,2016-11-08,7,ES
6462,Stony Point,2624,2664,2016-11-08,-40,HS
6463,Success,332,346,2016-11-08,-14,HS
6464,Teravista,839,867,2016-11-08,-28,ES
6465,Union Hill,772,796,2016-11-08,-24,ES
6466,Voigt,562,510,2016-11-08,52,ES
6467,Walsh,1688,1657,2016-11-08,31,MS
6468,Wells Branch,499,485,2016-11-08,14,ES
6469,Westwood,2674,2736,2016-11-08,-62,HS
6470,LOTT,16,15,2016-11-08,1,Other
6471,Anderson Mill,499,522,2016-11-15,-23,ES
6472,Berkman,468,491,2016-11-15,-23,ES
6473,Blackland Prairie,774,767,2016-11-15,7,ES
6474,Bluebonnet,432,546,2016-11-15,-114,ES
6475,Brushy Creek,807,831,2016-11-15,-24,ES
6476,C.D. Fulkes,690,712,2016-11-15,-22,MS
6477,Cactus Ranch,999,1001,2016-11-15,-2,ES
6478,Caldwell Heights,637,671,2016-11-15,-34,ES
6479,Callison,794,805,2016-11-15,-11,ES
6480,Canyon Creek,426,412,2016-11-15,14,ES
6481,Canyon Vista,1371,1410,2016-11-15,-39,MS
6482,Caraway,767,746,2016-11-15,21,ES
6483,Cedar Ridge,2718,2790,2016-11-15,-72,HS
6484,Cedar Valley,1446,1458,2016-11-15,-12,MS
6485,Chandler Oaks,550,495,2016-11-15,55,ES
6486,Chisholm Trail,1041,1026,2016-11-15,15,MS
6487,Deepwood,340,355,2016-11-15,-15,ES
6488,Deerpark,925,909,2016-11-15,16,MS
6489,Double File Trail,654,560,2016-11-15,94,ES
6490,DAEP,6,0,2016-11-15,6,Other
6491,England,967,956,2016-11-15,11,ES
6492,Fern Bluff,633,628,2016-11-15,5,ES
6493,Forest Creek,852,808,2016-11-15,44,ES
6494,Forest North,363,405,2016-11-15,-42,ES
6495,Gattis,693,719,2016-11-15,-26,ES
6496,Great Oaks,694,686,2016-11-15,8,ES
6497,Grisham,700,676,2016-11-15,24,MS
6498,Hernandez,801,777,2016-11-15,24,MS
6499,Herrington,996,935,2016-11-15,61,ES
6500,Hopewell,1057,1079,2016-11-15,-22,MS
6501,JJAEP,10,11,2016-11-15,-1,Other
6502,Johnson,522,502,2016-11-15,20,ES
6503,Jollyville,432,468,2016-11-15,-36,ES
6504,Laurel Mountain,785,811,2016-11-15,-26,ES
6505,Live Oak,561,589,2016-11-15,-28,ES
6506,McNeil,2632,2701,2016-11-15,-69,HS
6507,Old Town,802,637,2016-11-15,165,ES
6508,Pond Springs,668,620,2016-11-15,48,ES
6509,Purple Sage,390,341,2016-11-15,49,ES
6510,Round Rock Opportunity Center,132,41,2016-11-15,91,Other
6511,Ridgeview,1362,1369,2016-11-15,-7,MS
6512,Robertson,448,466,2016-11-15,-18,ES
6513,Round Rock,3202,3319,2016-11-15,-117,HS
6514,Sommer,1177,1127,2016-11-15,50,ES
6515,Spicewood,829,819,2016-11-15,10,ES
6516,Stony Point,2620,2664,2016-11-15,-44,HS
6517,Success,326,346,2016-11-15,-20,HS
6518,Teravista,844,867,2016-11-15,-23,ES
6519,Union Hill,770,796,2016-11-15,-26,ES
6520,Voigt,565,510,2016-11-15,55,ES
6521,Walsh,1690,1657,2016-11-15,33,MS
6522,Wells Branch,499,485,2016-11-15,14,ES
6523,Westwood,2665,2736,2016-11-15,-71,HS
6524,LOTT,12,15,2016-11-15,-3,Other
6525,Anderson Mill,495,522,2016-11-29,-27,ES
6526,Berkman,469,491,2016-11-29,-22,ES
6527,Blackland Prairie,776,767,2016-11-29,9,ES
6528,Bluebonnet,429,546,2016-11-29,-117,ES
6529,Brushy Creek,805,831,2016-11-29,-26,ES
6530,C.D. Fulkes,692,712,2016-11-29,-20,MS
6531,Cactus Ranch,995,1001,2016-11-29,-6,ES
6532,Caldwell Heights,636,671,2016-11-29,-35,ES
6533,Callison,795,805,2016-11-29,-10,ES
6534,Canyon Creek,426,412,2016-11-29,14,ES
6535,Canyon Vista,1370,1410,2016-11-29,-40,MS
6536,Caraway,765,746,2016-11-29,19,ES
6537,Cedar Ridge,2722,2790,2016-11-29,-68,HS
6538,Cedar Valley,1450,1458,2016-11-29,-8,MS
6539,Chandler Oaks,552,495,2016-11-29,57,ES
6540,Chisholm Trail,1040,1026,2016-11-29,14,MS
6541,Deepwood,343,355,2016-11-29,-12,ES
6542,Deerpark,924,909,2016-11-29,15,MS
6543,Double File Trail,658,560,2016-11-29,98,ES
6544,DAEP,5,0,2016-11-29,5,Other
6545,England,971,956,2016-11-29,15,ES
6546,Fern Bluff,631,628,2016-11-29,3,ES
6547,Forest Creek,853,808,2016-11-29,45,ES
6548,Forest North,358,405,2016-11-29,-47,ES
6549,Gattis,690,719,2016-11-29,-29,ES
6550,Great Oaks,694,686,2016-11-29,8,ES
6551,Grisham,700,676,2016-11-29,24,MS
6552,Hernandez,802,777,2016-11-29,25,MS
6553,Herrington,994,935,2016-11-29,59,ES
6554,Hopewell,1060,1079,2016-11-29,-19,MS
6555,JJAEP,10,11,2016-11-29,-1,Other
6556,Johnson,525,502,2016-11-29,23,ES
6557,Jollyville,430,468,2016-11-29,-38,ES
6558,Laurel Mountain,789,811,2016-11-29,-22,ES
6559,Live Oak,560,589,2016-11-29,-29,ES
6560,McNeil,2631,2701,2016-11-29,-70,HS
6561,Old Town,802,637,2016-11-29,165,ES
6562,Pond Springs,663,620,2016-11-29,43,ES
6563,Purple Sage,389,341,2016-11-29,48,ES
6564,Round Rock Opportunity Center,129,41,2016-11-29,88,Other
6565,Ridgeview,1363,1369,2016-11-29,-6,MS
6566,Robertson,444,466,2016-11-29,-22,ES
6567,Round Rock,3205,3319,2016-11-29,-114,HS
6568,Sommer,1176,1127,2016-11-29,49,ES
6569,Spicewood,832,819,2016-11-29,13,ES
6570,Stony Point,2619,2664,2016-11-29,-45,HS
6571,Success,325,346,2016-11-29,-21,HS
6572,Teravista,848,867,2016-11-29,-19,ES
6573,Union Hill,774,796,2016-11-29,-22,ES
6574,Voigt,562,510,2016-11-29,52,ES
6575,Walsh,1689,1657,2016-11-29,32,MS
6576,Wells Branch,495,485,2016-11-29,10,ES
6577,Westwood,2664,2736,2016-11-29,-72,HS
6578,LOTT,10,15,2016-11-29,-5,Other
6579,Anderson Mill,494,522,2016-12-06,-28,ES
6580,Berkman,469,491,2016-12-06,-22,ES
6581,Blackland Prairie,777,767,2016-12-06,10,ES
6582,Bluebonnet,431,546,2016-12-06,-115,ES
6583,Brushy Creek,806,831,2016-12-06,-25,ES
6584,C.D. Fulkes,691,712,2016-12-06,-21,MS
6585,Cactus Ranch,989,1001,2016-12-06,-12,ES
6586,Caldwell Heights,636,671,2016-12-06,-35,ES
6587,Callison,797,805,2016-12-06,-8,ES
6588,Canyon Creek,427,412,2016-12-06,15,ES
6589,Canyon Vista,1371,1410,2016-12-06,-39,MS
6590,Caraway,763,746,2016-12-06,17,ES
6591,Cedar Ridge,2714,2790,2016-12-06,-76,HS
6592,Cedar Valley,1449,1458,2016-12-06,-9,MS
6593,Chandler Oaks,553,495,2016-12-06,58,ES
6594,Chisholm Trail,1040,1026,2016-12-06,14,MS
6595,Deepwood,342,355,2016-12-06,-13,ES
6596,Deerpark,926,909,2016-12-06,17,MS
6597,Double File Trail,659,560,2016-12-06,99,ES
6598,DAEP,5,0,2016-12-06,5,Other
6599,England,974,956,2016-12-06,18,ES
6600,Fern Bluff,632,628,2016-12-06,4,ES
6601,Forest Creek,855,808,2016-12-06,47,ES
6602,Forest North,351,405,2016-12-06,-54,ES
6603,Gattis,691,719,2016-12-06,-28,ES
6604,Great Oaks,695,686,2016-12-06,9,ES
6605,Grisham,704,676,2016-12-06,28,MS
6606,Hernandez,802,777,2016-12-06,25,MS
6607,Herrington,993,935,2016-12-06,58,ES
6608,Hopewell,1061,1079,2016-12-06,-18,MS
6609,JJAEP,10,11,2016-12-06,-1,Other
6610,Johnson,532,502,2016-12-06,30,ES
6611,Jollyville,436,468,2016-12-06,-32,ES
6612,Laurel Mountain,789,811,2016-12-06,-22,ES
6613,Live Oak,562,589,2016-12-06,-27,ES
6614,McNeil,2630,2701,2016-12-06,-71,HS
6615,Old Town,804,637,2016-12-06,167,ES
6616,Pond Springs,664,620,2016-12-06,44,ES
6617,Purple Sage,389,341,2016-12-06,48,ES
6618,Round Rock Opportunity Center,138,41,2016-12-06,97,Other
6619,Ridgeview,1361,1369,2016-12-06,-8,MS
6620,Robertson,445,466,2016-12-06,-21,ES
6621,Round Rock,3205,3319,2016-12-06,-114,HS
6622,Sommer,1178,1127,2016-12-06,51,ES
6623,Spicewood,829,819,2016-12-06,10,ES
6624,Stony Point,2612,2664,2016-12-06,-52,HS
6625,Success,310,346,2016-12-06,-36,HS
6626,Teravista,846,867,2016-12-06,-21,ES
6627,Union Hill,772,796,2016-12-06,-24,ES
6628,Voigt,562,510,2016-12-06,52,ES
6629,Walsh,1688,1657,2016-12-06,31,MS
6630,Wells Branch,494,485,2016-12-06,9,ES
6631,Westwood,2663,2736,2016-12-06,-73,HS
6632,LOTT,10,15,2016-12-06,-5,Other
6633,Anderson Mill,491,522,2016-12-13,-31,ES
6634,Berkman,469,491,2016-12-13,-22,ES
6635,Blackland Prairie,775,767,2016-12-13,8,ES
6636,Bluebonnet,431,546,2016-12-13,-115,ES
6637,Brushy Creek,810,831,2016-12-13,-21,ES
6638,C.D. Fulkes,690,712,2016-12-13,-22,MS
6639,Cactus Ranch,990,1001,2016-12-13,-11,ES
6640,Caldwell Heights,638,671,2016-12-13,-33,ES
6641,Callison,798,805,2016-12-13,-7,ES
6642,Canyon Creek,427,412,2016-12-13,15,ES
6643,Canyon Vista,1371,1410,2016-12-13,-39,MS
6644,Caraway,762,746,2016-12-13,16,ES
6645,Cedar Ridge,2710,2790,2016-12-13,-80,HS
6646,Cedar Valley,1445,1458,2016-12-13,-13,MS
6647,Chandler Oaks,553,495,2016-12-13,58,ES
6648,Chisholm Trail,1040,1026,2016-12-13,14,MS
6649,Deepwood,342,355,2016-12-13,-13,ES
6650,Deerpark,925,909,2016-12-13,16,MS
6651,Double File Trail,660,560,2016-12-13,100,ES
6652,DAEP,6,0,2016-12-13,6,Other
6653,England,973,956,2016-12-13,17,ES
6654,Fern Bluff,633,628,2016-12-13,5,ES
6655,Forest Creek,856,808,2016-12-13,48,ES
6656,Forest North,353,405,2016-12-13,-52,ES
6657,Gattis,691,719,2016-12-13,-28,ES
6658,Great Oaks,695,686,2016-12-13,9,ES
6659,Grisham,705,676,2016-12-13,29,MS
6660,Hernandez,804,777,2016-12-13,27,MS
6661,Herrington,994,935,2016-12-13,59,ES
6662,Hopewell,1061,1079,2016-12-13,-18,MS
6663,JJAEP,10,11,2016-12-13,-1,Other
6664,Johnson,532,502,2016-12-13,30,ES
6665,Jollyville,437,468,2016-12-13,-31,ES
6666,Laurel Mountain,790,811,2016-12-13,-21,ES
6667,Live Oak,562,589,2016-12-13,-27,ES
6668,McNeil,2627,2701,2016-12-13,-74,HS
6669,Old Town,804,637,2016-12-13,167,ES
6670,Pond Springs,662,620,2016-12-13,42,ES
6671,Purple Sage,388,341,2016-12-13,47,ES
6672,Round Rock Opportunity Center,146,41,2016-12-13,105,Other
6673,Ridgeview,1360,1369,2016-12-13,-9,MS
6674,Robertson,446,466,2016-12-13,-20,ES
6675,Round Rock,3205,3319,2016-12-13,-114,HS
6676,Sommer,1175,1127,2016-12-13,48,ES
6677,Spicewood,829,819,2016-12-13,10,ES
6678,Stony Point,2609,2664,2016-12-13,-55,HS
6679,Success,298,346,2016-12-13,-48,HS
6680,Teravista,847,867,2016-12-13,-20,ES
6681,Union Hill,770,796,2016-12-13,-26,ES
6682,Voigt,564,510,2016-12-13,54,ES
6683,Walsh,1688,1657,2016-12-13,31,MS
6684,Wells Branch,493,485,2016-12-13,8,ES
6685,Westwood,2662,2736,2016-12-13,-74,HS
6686,LOTT,10,15,2016-12-13,-5,Other
6687,Anderson Mill,496,522,2017-01-10,-26,ES
6688,Berkman,465,491,2017-01-10,-26,ES
6689,Blackland Prairie,780,767,2017-01-10,13,ES
6690,Bluebonnet,424,546,2017-01-10,-122,ES
6691,Brushy Creek,809,831,2017-01-10,-22,ES
6692,C.D. Fulkes,689,712,2017-01-10,-23,MS
6693,Cactus Ranch,1003,1001,2017-01-10,2,ES
6694,Caldwell Heights,649,671,2017-01-10,-22,ES
6695,Callison,803,805,2017-01-10,-2,ES
6696,Canyon Creek,429,412,2017-01-10,17,ES
6697,Canyon Vista,1365,1410,2017-01-10,-45,MS
6698,Caraway,762,746,2017-01-10,16,ES
6699,Cedar Ridge,2710,2790,2017-01-10,-80,HS
6700,Cedar Valley,1449,1458,2017-01-10,-9,MS
6701,Chandler Oaks,556,495,2017-01-10,61,ES
6702,Chisholm Trail,1048,1026,2017-01-10,22,MS
6703,Deepwood,345,355,2017-01-10,-10,ES
6704,Deerpark,920,909,2017-01-10,11,MS
6705,Double File Trail,657,560,2017-01-10,97,ES
6706,DAEP,7,0,2017-01-10,7,Other
6707,England,982,956,2017-01-10,26,ES
6708,Fern Bluff,633,628,2017-01-10,5,ES
6709,Forest Creek,853,808,2017-01-10,45,ES
6710,Forest North,351,405,2017-01-10,-54,ES
6711,Gattis,688,719,2017-01-10,-31,ES
6712,Great Oaks,701,686,2017-01-10,15,ES
6713,Grisham,716,676,2017-01-10,40,MS
6714,Hernandez,799,777,2017-01-10,22,MS
6715,Herrington,987,935,2017-01-10,52,ES
6716,Hopewell,1066,1079,2017-01-10,-13,MS
6717,JJAEP,11,11,2017-01-10,0,Other
6718,Johnson,542,502,2017-01-10,40,ES
6719,Jollyville,438,468,2017-01-10,-30,ES
6720,Laurel Mountain,789,811,2017-01-10,-22,ES
6721,Live Oak,556,589,2017-01-10,-33,ES
6722,McNeil,2633,2701,2017-01-10,-68,HS
6723,Old Town,800,637,2017-01-10,163,ES
6724,Pond Springs,663,620,2017-01-10,43,ES
6725,Purple Sage,393,341,2017-01-10,52,ES
6726,Round Rock Opportunity Center,133,41,2017-01-10,92,Other
6727,Ridgeview,1369,1369,2017-01-10,0,MS
6728,Robertson,444,466,2017-01-10,-22,ES
6729,Round Rock,3203,3319,2017-01-10,-116,HS
6730,Sommer,1191,1127,2017-01-10,64,ES
6731,Spicewood,833,819,2017-01-10,14,ES
6732,Stony Point,2612,2664,2017-01-10,-52,HS
6733,Success,312,346,2017-01-10,-34,HS
6734,Teravista,849,867,2017-01-10,-18,ES
6735,Union Hill,774,796,2017-01-10,-22,ES
6736,Voigt,563,510,2017-01-10,53,ES
6737,Walsh,1686,1657,2017-01-10,29,MS
6738,Wells Branch,498,485,2017-01-10,13,ES
6739,Westwood,2664,2736,2017-01-10,-72,HS
6740,LOTT,14,15,2017-01-10,-1,Other
6741,Anderson Mill,497,522,2017-01-17,-25,ES
6742,Berkman,461,491,2017-01-17,-30,ES
6743,Blackland Prairie,783,767,2017-01-17,16,ES
6744,Bluebonnet,425,546,2017-01-17,-121,ES
6745,Brushy Creek,809,831,2017-01-17,-22,ES
6746,C.D. Fulkes,687,712,2017-01-17,-25,MS
6747,Cactus Ranch,1004,1001,2017-01-17,3,ES
6748,Caldwell Heights,651,671,2017-01-17,-20,ES
6749,Callison,807,805,2017-01-17,2,ES
6750,Canyon Creek,429,412,2017-01-17,17,ES
6751,Canyon Vista,1363,1410,2017-01-17,-47,MS
6752,Caraway,768,746,2017-01-17,22,ES
6753,Cedar Ridge,2709,2790,2017-01-17,-81,HS
6754,Cedar Valley,1451,1458,2017-01-17,-7,MS
6755,Chandler Oaks,556,495,2017-01-17,61,ES
6756,Chisholm Trail,1048,1026,2017-01-17,22,MS
6757,Deepwood,343,355,2017-01-17,-12,ES
6758,Deerpark,924,909,2017-01-17,15,MS
6759,Double File Trail,660,560,2017-01-17,100,ES
6760,DAEP,7,0,2017-01-17,7,Other
6761,England,981,956,2017-01-17,25,ES
6762,Fern Bluff,633,628,2017-01-17,5,ES
6763,Forest Creek,853,808,2017-01-17,45,ES
6764,Forest North,349,405,2017-01-17,-56,ES
6765,Gattis,687,719,2017-01-17,-32,ES
6766,Great Oaks,700,686,2017-01-17,14,ES
6767,Grisham,719,676,2017-01-17,43,MS
6768,Hernandez,798,777,2017-01-17,21,MS
6769,Herrington,985,935,2017-01-17,50,ES
6770,Hopewell,1069,1079,2017-01-17,-10,MS
6771,JJAEP,9,11,2017-01-17,-2,Other
6772,Johnson,542,502,2017-01-17,40,ES
6773,Jollyville,441,468,2017-01-17,-27,ES
6774,Laurel Mountain,789,811,2017-01-17,-22,ES
6775,Live Oak,556,589,2017-01-17,-33,ES
6776,McNeil,2630,2701,2017-01-17,-71,HS
6777,Old Town,800,637,2017-01-17,163,ES
6778,Pond Springs,665,620,2017-01-17,45,ES
6779,Purple Sage,395,341,2017-01-17,54,ES
6780,Round Rock Opportunity Center,133,41,2017-01-17,92,Other
6781,Ridgeview,1371,1369,2017-01-17,2,MS
6782,Robertson,442,466,2017-01-17,-24,ES
6783,Round Rock,3187,3319,2017-01-17,-132,HS
6784,Sommer,1193,1127,2017-01-17,66,ES
6785,Spicewood,832,819,2017-01-17,13,ES
6786,Stony Point,2608,2664,2017-01-17,-56,HS
6787,Success,321,346,2017-01-17,-25,HS
6788,Teravista,848,867,2017-01-17,-19,ES
6789,Union Hill,785,796,2017-01-17,-11,ES
6790,Voigt,566,510,2017-01-17,56,ES
6791,Walsh,1687,1657,2017-01-17,30,MS
6792,Wells Branch,497,485,2017-01-17,12,ES
6793,Westwood,2664,2736,2017-01-17,-72,HS
6794,LOTT,14,15,2017-01-17,-1,Other
6795,Anderson Mill,500,522,2017-01-24,-22,ES
6796,Berkman,460,491,2017-01-24,-31,ES
6797,Blackland Prairie,781,767,2017-01-24,14,ES
6798,Bluebonnet,425,546,2017-01-24,-121,ES
6799,Brushy Creek,806,831,2017-01-24,-25,ES
6800,C.D. Fulkes,690,712,2017-01-24,-22,MS
6801,Cactus Ranch,1004,1001,2017-01-24,3,ES
6802,Caldwell Heights,655,671,2017-01-24,-16,ES
6803,Callison,807,805,2017-01-24,2,ES
6804,Canyon Creek,427,412,2017-01-24,15,ES
6805,Canyon Vista,1362,1410,2017-01-24,-48,MS
6806,Caraway,772,746,2017-01-24,26,ES
6807,Cedar Ridge,2704,2790,2017-01-24,-86,HS
6808,Cedar Valley,1451,1458,2017-01-24,-7,MS
6809,Chandler Oaks,554,495,2017-01-24,59,ES
6810,Chisholm Trail,1047,1026,2017-01-24,21,MS
6811,Deepwood,343,355,2017-01-24,-12,ES
6812,Deerpark,930,909,2017-01-24,21,MS
6813,Double File Trail,658,560,2017-01-24,98,ES
6814,DAEP,9,0,2017-01-24,9,Other
6815,England,983,956,2017-01-24,27,ES
6816,Fern Bluff,633,628,2017-01-24,5,ES
6817,Forest Creek,853,808,2017-01-24,45,ES
6818,Forest North,349,405,2017-01-24,-56,ES
6819,Gattis,690,719,2017-01-24,-29,ES
6820,Great Oaks,700,686,2017-01-24,14,ES
6821,Grisham,722,676,2017-01-24,46,MS
6822,Hernandez,798,777,2017-01-24,21,MS
6823,Herrington,988,935,2017-01-24,53,ES
6824,Hopewell,1071,1079,2017-01-24,-8,MS
6825,JJAEP,10,11,2017-01-24,-1,Other
6826,Johnson,537,502,2017-01-24,35,ES
6827,Jollyville,442,468,2017-01-24,-26,ES
6828,Laurel Mountain,787,811,2017-01-24,-24,ES
6829,Live Oak,556,589,2017-01-24,-33,ES
6830,McNeil,2626,2701,2017-01-24,-75,HS
6831,Old Town,799,637,2017-01-24,162,ES
6832,Pond Springs,665,620,2017-01-24,45,ES
6833,Purple Sage,395,341,2017-01-24,54,ES
6834,Round Rock Opportunity Center,120,41,2017-01-24,79,Other
6835,Ridgeview,1371,1369,2017-01-24,2,MS
6836,Robertson,438,466,2017-01-24,-28,ES
6837,Round Rock,3181,3319,2017-01-24,-138,HS
6838,Sommer,1195,1127,2017-01-24,68,ES
6839,Spicewood,828,819,2017-01-24,9,ES
6840,Stony Point,2602,2664,2017-01-24,-62,HS
6841,Success,313,346,2017-01-24,-33,HS
6842,Teravista,849,867,2017-01-24,-18,ES
6843,Union Hill,784,796,2017-01-24,-12,ES
6844,Voigt,567,510,2017-01-24,57,ES
6845,Walsh,1684,1657,2017-01-24,27,MS
6846,Wells Branch,496,485,2017-01-24,11,ES
6847,Westwood,2661,2736,2017-01-24,-75,HS
6848,LOTT,14,15,2017-01-24,-1,Other
6849,Anderson Mill,502,522,2017-01-31,-20,ES
6850,Berkman,459,491,2017-01-31,-32,ES
6851,Blackland Prairie,782,767,2017-01-31,15,ES
6852,Bluebonnet,425,546,2017-01-31,-121,ES
6853,Brushy Creek,806,831,2017-01-31,-25,ES
6854,C.D. Fulkes,690,712,2017-01-31,-22,MS
6855,Cactus Ranch,1001,1001,2017-01-31,0,ES
6856,Caldwell Heights,655,671,2017-01-31,-16,ES
6857,Callison,812,805,2017-01-31,7,ES
6858,Canyon Creek,427,412,2017-01-31,15,ES
6859,Canyon Vista,1358,1410,2017-01-31,-52,MS
6860,Caraway,771,746,2017-01-31,25,ES
6861,Cedar Ridge,2699,2790,2017-01-31,-91,HS
6862,Cedar Valley,1450,1458,2017-01-31,-8,MS
6863,Chandler Oaks,554,495,2017-01-31,59,ES
6864,Chisholm Trail,1044,1026,2017-01-31,18,MS
6865,Deepwood,344,355,2017-01-31,-11,ES
6866,Deerpark,928,909,2017-01-31,19,MS
6867,Double File Trail,655,560,2017-01-31,95,ES
6868,DAEP,9,0,2017-01-31,9,Other
6869,England,984,956,2017-01-31,28,ES
6870,Fern Bluff,633,628,2017-01-31,5,ES
6871,Forest Creek,853,808,2017-01-31,45,ES
6872,Forest North,346,405,2017-01-31,-59,ES
6873,Gattis,691,719,2017-01-31,-28,ES
6874,Great Oaks,701,686,2017-01-31,15,ES
6875,Grisham,723,676,2017-01-31,47,MS
6876,Hernandez,796,777,2017-01-31,19,MS
6877,Herrington,993,935,2017-01-31,58,ES
6878,Hopewell,1067,1079,2017-01-31,-12,MS
6879,JJAEP,9,11,2017-01-31,-2,Other
6880,Johnson,537,502,2017-01-31,35,ES
6881,Jollyville,442,468,2017-01-31,-26,ES
6882,Laurel Mountain,788,811,2017-01-31,-23,ES
6883,Live Oak,554,589,2017-01-31,-35,ES
6884,McNeil,2627,2701,2017-01-31,-74,HS
6885,Old Town,797,637,2017-01-31,160,ES
6886,Pond Springs,664,620,2017-01-31,44,ES
6887,Purple Sage,396,341,2017-01-31,55,ES
6888,Round Rock Opportunity Center,122,41,2017-01-31,81,Other
6889,Ridgeview,1372,1369,2017-01-31,3,MS
6890,Robertson,436,466,2017-01-31,-30,ES
6891,Round Rock,3177,3319,2017-01-31,-142,HS
6892,Sommer,1195,1127,2017-01-31,68,ES
6893,Spicewood,826,819,2017-01-31,7,ES
6894,Stony Point,2592,2664,2017-01-31,-72,HS
6895,Success,324,346,2017-01-31,-22,HS
6896,Teravista,851,867,2017-01-31,-16,ES
6897,Union Hill,783,796,2017-01-31,-13,ES
6898,Voigt,570,510,2017-01-31,60,ES
6899,Walsh,1685,1657,2017-01-31,28,MS
6900,Wells Branch,497,485,2017-01-31,12,ES
6901,Westwood,2659,2736,2017-01-31,-77,HS
6902,LOTT,16,15,2017-01-31,1,Other
6903,Anderson Mill,506,522,2017-02-07,-16,ES
6904,Berkman,457,491,2017-02-07,-34,ES
6905,Blackland Prairie,782,767,2017-02-07,15,ES
6906,Bluebonnet,421,546,2017-02-07,-125,ES
6907,Brushy Creek,807,831,2017-02-07,-24,ES
6908,C.D. Fulkes,683,712,2017-02-07,-29,MS
6909,Cactus Ranch,1003,1001,2017-02-07,2,ES
6910,Caldwell Heights,661,671,2017-02-07,-10,ES
6911,Callison,814,805,2017-02-07,9,ES
6912,Canyon Creek,429,412,2017-02-07,17,ES
6913,Canyon Vista,1358,1410,2017-02-07,-52,MS
6914,Caraway,771,746,2017-02-07,25,ES
6915,Cedar Ridge,2692,2790,2017-02-07,-98,HS
6916,Cedar Valley,1452,1458,2017-02-07,-6,MS
6917,Chandler Oaks,555,495,2017-02-07,60,ES
6918,Chisholm Trail,1047,1026,2017-02-07,21,MS
6919,Deepwood,344,355,2017-02-07,-11,ES
6920,Deerpark,931,909,2017-02-07,22,MS
6921,Double File Trail,662,560,2017-02-07,102,ES
6922,DAEP,11,0,2017-02-07,11,Other
6923,England,985,956,2017-02-07,29,ES
6924,Fern Bluff,633,628,2017-02-07,5,ES
6925,Forest Creek,853,808,2017-02-07,45,ES
6926,Forest North,347,405,2017-02-07,-58,ES
6927,Gattis,690,719,2017-02-07,-29,ES
6928,Great Oaks,704,686,2017-02-07,18,ES
6929,Grisham,721,676,2017-02-07,45,MS
6930,Hernandez,798,777,2017-02-07,21,MS
6931,Herrington,994,935,2017-02-07,59,ES
6932,Hopewell,1069,1079,2017-02-07,-10,MS
6933,JJAEP,10,11,2017-02-07,-1,Other
6934,Johnson,532,502,2017-02-07,30,ES
6935,Jollyville,443,468,2017-02-07,-25,ES
6936,Laurel Mountain,788,811,2017-02-07,-23,ES
6937,Live Oak,554,589,2017-02-07,-35,ES
6938,McNeil,2630,2701,2017-02-07,-71,HS
6939,Old Town,800,637,2017-02-07,163,ES
6940,Pond Springs,664,620,2017-02-07,44,ES
6941,Purple Sage,399,341,2017-02-07,58,ES
6942,Round Rock Opportunity Center,134,41,2017-02-07,93,Other
6943,Ridgeview,1372,1369,2017-02-07,3,MS
6944,Robertson,445,466,2017-02-07,-21,ES
6945,Round Rock,3170,3319,2017-02-07,-149,HS
6946,Sommer,1195,1127,2017-02-07,68,ES
6947,Spicewood,828,819,2017-02-07,9,ES
6948,Stony Point,2580,2664,2017-02-07,-84,HS
6949,Success,329,346,2017-02-07,-17,HS
6950,Teravista,854,867,2017-02-07,-13,ES
6951,Union Hill,783,796,2017-02-07,-13,ES
6952,Voigt,569,510,2017-02-07,59,ES
6953,Walsh,1684,1657,2017-02-07,27,MS
6954,Wells Branch,495,485,2017-02-07,10,ES
6955,Westwood,2659,2736,2017-02-07,-77,HS
6956,LOTT,14,15,2017-02-07,-1,Other
6957,Anderson Mill,507,522,2017-02-14,-15,ES
6958,Berkman,459,491,2017-02-14,-32,ES
6959,Blackland Prairie,783,767,2017-02-14,16,ES
6960,Bluebonnet,421,546,2017-02-14,-125,ES
6961,Brushy Creek,808,831,2017-02-14,-23,ES
6962,C.D. Fulkes,684,712,2017-02-14,-28,MS
6963,Cactus Ranch,1004,1001,2017-02-14,3,ES
6964,Caldwell Heights,661,671,2017-02-14,-10,ES
6965,Callison,807,805,2017-02-14,2,ES
6966,Canyon Creek,429,412,2017-02-14,17,ES
6967,Canyon Vista,1357,1410,2017-02-14,-53,MS
6968,Caraway,772,746,2017-02-14,26,ES
6969,Cedar Ridge,2694,2790,2017-02-14,-96,HS
6970,Cedar Valley,1449,1458,2017-02-14,-9,MS
6971,Chandler Oaks,554,495,2017-02-14,59,ES
6972,Chisholm Trail,1048,1026,2017-02-14,22,MS
6973,Deepwood,344,355,2017-02-14,-11,ES
6974,Deerpark,933,909,2017-02-14,24,MS
6975,Double File Trail,660,560,2017-02-14,100,ES
6976,DAEP,12,0,2017-02-14,12,Other
6977,England,986,956,2017-02-14,30,ES
6978,Fern Bluff,633,628,2017-02-14,5,ES
6979,Forest Creek,851,808,2017-02-14,43,ES
6980,Forest North,348,405,2017-02-14,-57,ES
6981,Gattis,688,719,2017-02-14,-31,ES
6982,Great Oaks,707,686,2017-02-14,21,ES
6983,Grisham,721,676,2017-02-14,45,MS
6984,Hernandez,796,777,2017-02-14,19,MS
6985,Herrington,994,935,2017-02-14,59,ES
6986,Hopewell,1070,1079,2017-02-14,-9,MS
6987,JJAEP,10,11,2017-02-14,-1,Other
6988,Johnson,536,502,2017-02-14,34,ES
6989,Jollyville,444,468,2017-02-14,-24,ES
6990,Laurel Mountain,791,811,2017-02-14,-20,ES
6991,Live Oak,554,589,2017-02-14,-35,ES
6992,McNeil,2629,2701,2017-02-14,-72,HS
6993,Old Town,798,637,2017-02-14,161,ES
6994,Pond Springs,666,620,2017-02-14,46,ES
6995,Purple Sage,399,341,2017-02-14,58,ES
6996,Round Rock Opportunity Center,129,41,2017-02-14,88,Other
6997,Ridgeview,1371,1369,2017-02-14,2,MS
6998,Robertson,441,466,2017-02-14,-25,ES
6999,Round Rock,3164,3319,2017-02-14,-155,HS
7000,Sommer,1195,1127,2017-02-14,68,ES
7001,Spicewood,828,819,2017-02-14,9,ES
7002,Stony Point,2583,2664,2017-02-14,-81,HS
7003,Success,323,346,2017-02-14,-23,HS
7004,Teravista,856,867,2017-02-14,-11,ES
7005,Union Hill,789,796,2017-02-14,-7,ES
7006,Voigt,569,510,2017-02-14,59,ES
7007,Walsh,1685,1657,2017-02-14,28,MS
7008,Wells Branch,497,485,2017-02-14,12,ES
7009,Westwood,2660,2736,2017-02-14,-76,HS
7010,LOTT,14,15,2017-02-14,-1,Other
7011,Anderson Mill,508,522,2017-02-21,-14,ES
7012,Berkman,459,491,2017-02-21,-32,ES
7013,Blackland Prairie,782,767,2017-02-21,15,ES
7014,Bluebonnet,418,546,2017-02-21,-128,ES
7015,Brushy Creek,806,831,2017-02-21,-25,ES
7016,C.D. Fulkes,680,712,2017-02-21,-32,MS
7017,Cactus Ranch,1004,1001,2017-02-21,3,ES
7018,Caldwell Heights,661,671,2017-02-21,-10,ES
7019,Callison,809,805,2017-02-21,4,ES
7020,Canyon Creek,429,412,2017-02-21,17,ES
7021,Canyon Vista,1356,1410,2017-02-21,-54,MS
7022,Caraway,773,746,2017-02-21,27,ES
7023,Cedar Ridge,2688,2790,2017-02-21,-102,HS
7024,Cedar Valley,1448,1458,2017-02-21,-10,MS
7025,Chandler Oaks,553,495,2017-02-21,58,ES
7026,Chisholm Trail,1050,1026,2017-02-21,24,MS
7027,Deepwood,345,355,2017-02-21,-10,ES
7028,Deerpark,936,909,2017-02-21,27,MS
7029,Double File Trail,661,560,2017-02-21,101,ES
7030,DAEP,14,0,2017-02-21,14,Other
7031,England,986,956,2017-02-21,30,ES
7032,Fern Bluff,633,628,2017-02-21,5,ES
7033,Forest Creek,850,808,2017-02-21,42,ES
7034,Forest North,351,405,2017-02-21,-54,ES
7035,Gattis,690,719,2017-02-21,-29,ES
7036,Great Oaks,709,686,2017-02-21,23,ES
7037,Grisham,722,676,2017-02-21,46,MS
7038,Hernandez,800,777,2017-02-21,23,MS
7039,Herrington,992,935,2017-02-21,57,ES
7040,Hopewell,1068,1079,2017-02-21,-11,MS
7041,JJAEP,10,11,2017-02-21,-1,Other
7042,Johnson,534,502,2017-02-21,32,ES
7043,Jollyville,448,468,2017-02-21,-20,ES
7044,Laurel Mountain,791,811,2017-02-21,-20,ES
7045,Live Oak,552,589,2017-02-21,-37,ES
7046,McNeil,2622,2701,2017-02-21,-79,HS
7047,Old Town,795,637,2017-02-21,158,ES
7048,Pond Springs,665,620,2017-02-21,45,ES
7049,Purple Sage,398,341,2017-02-21,57,ES
7050,Round Rock Opportunity Center,124,41,2017-02-21,83,Other
7051,Ridgeview,1372,1369,2017-02-21,3,MS
7052,Robertson,443,466,2017-02-21,-23,ES
7053,Round Rock,3158,3319,2017-02-21,-161,HS
7054,Sommer,1196,1127,2017-02-21,69,ES
7055,Spicewood,827,819,2017-02-21,8,ES
7056,Stony Point,2587,2664,2017-02-21,-77,HS
7057,Success,321,346,2017-02-21,-25,HS
7058,Teravista,856,867,2017-02-21,-11,ES
7059,Union Hill,788,796,2017-02-21,-8,ES
7060,Voigt,568,510,2017-02-21,58,ES
7061,Walsh,1685,1657,2017-02-21,28,MS
7062,Wells Branch,500,485,2017-02-21,15,ES
7063,Westwood,2662,2736,2017-02-21,-74,HS
7064,LOTT,16,15,2017-02-21,1,Other
7065,Anderson Mill,511,522,2017-02-28,-11,ES
7066,Berkman,456,491,2017-02-28,-35,ES
7067,Blackland Prairie,781,767,2017-02-28,14,ES
7068,Bluebonnet,418,546,2017-02-28,-128,ES
7069,Brushy Creek,810,831,2017-02-28,-21,ES
7070,C.D. Fulkes,677,712,2017-02-28,-35,MS
7071,Cactus Ranch,1008,1001,2017-02-28,7,ES
7072,Caldwell Heights,662,671,2017-02-28,-9,ES
7073,Callison,807,805,2017-02-28,2,ES
7074,Canyon Creek,429,412,2017-02-28,17,ES
7075,Canyon Vista,1356,1410,2017-02-28,-54,MS
7076,Caraway,778,746,2017-02-28,32,ES
7077,Cedar Ridge,2688,2790,2017-02-28,-102,HS
7078,Cedar Valley,1449,1458,2017-02-28,-9,MS
7079,Chandler Oaks,548,495,2017-02-28,53,ES
7080,Chisholm Trail,1053,1026,2017-02-28,27,MS
7081,Deepwood,345,355,2017-02-28,-10,ES
7082,Deerpark,938,909,2017-02-28,29,MS
7083,Double File Trail,660,560,2017-02-28,100,ES
7084,DAEP,14,0,2017-02-28,14,Other
7085,England,988,956,2017-02-28,32,ES
7086,Fern Bluff,637,628,2017-02-28,9,ES
7087,Forest Creek,850,808,2017-02-28,42,ES
7088,Forest North,349,405,2017-02-28,-56,ES
7089,Gattis,693,719,2017-02-28,-26,ES
7090,Great Oaks,711,686,2017-02-28,25,ES
7091,Grisham,723,676,2017-02-28,47,MS
7092,Hernandez,793,777,2017-02-28,16,MS
7093,Herrington,998,935,2017-02-28,63,ES
7094,Hopewell,1071,1079,2017-02-28,-8,MS
7095,JJAEP,9,11,2017-02-28,-2,Other
7096,Johnson,537,502,2017-02-28,35,ES
7097,Jollyville,451,468,2017-02-28,-17,ES
7098,Laurel Mountain,790,811,2017-02-28,-21,ES
7099,Live Oak,552,589,2017-02-28,-37,ES
7100,McNeil,2623,2701,2017-02-28,-78,HS
7101,Old Town,798,637,2017-02-28,161,ES
7102,Pond Springs,666,620,2017-02-28,46,ES
7103,Purple Sage,398,341,2017-02-28,57,ES
7104,Round Rock Opportunity Center,125,41,2017-02-28,84,Other
7105,Ridgeview,1373,1369,2017-02-28,4,MS
7106,Robertson,446,466,2017-02-28,-20,ES
7107,Round Rock,3162,3319,2017-02-28,-157,HS
7108,Sommer,1197,1127,2017-02-28,70,ES
7109,Spicewood,827,819,2017-02-28,8,ES
7110,Stony Point,2582,2664,2017-02-28,-82,HS
7111,Success,324,346,2017-02-28,-22,HS
7112,Teravista,855,867,2017-02-28,-12,ES
7113,Union Hill,787,796,2017-02-28,-9,ES
7114,Voigt,564,510,2017-02-28,54,ES
7115,Walsh,1686,1657,2017-02-28,29,MS
7116,Wells Branch,501,485,2017-02-28,16,ES
7117,Westwood,2661,2736,2017-02-28,-75,HS
7118,LOTT,13,15,2017-02-28,-2,Other
7119,Anderson Mill,509,522,2017-03-07,-13,ES
7120,Berkman,455,491,2017-03-07,-36,ES
7121,Blackland Prairie,785,767,2017-03-07,18,ES
7122,Bluebonnet,419,546,2017-03-07,-127,ES
7123,Brushy Creek,814,831,2017-03-07,-17,ES
7124,C.D. Fulkes,676,712,2017-03-07,-36,MS
7125,Cactus Ranch,1009,1001,2017-03-07,8,ES
7126,Caldwell Heights,668,671,2017-03-07,-3,ES
7127,Callison,807,805,2017-03-07,2,ES
7128,Canyon Creek,429,412,2017-03-07,17,ES
7129,Canyon Vista,1355,1410,2017-03-07,-55,MS
7130,Caraway,785,746,2017-03-07,39,ES
7131,Cedar Ridge,2684,2790,2017-03-07,-106,HS
7132,Cedar Valley,1447,1458,2017-03-07,-11,MS
7133,Chandler Oaks,547,495,2017-03-07,52,ES
7134,Chisholm Trail,1051,1026,2017-03-07,25,MS
7135,Deepwood,346,355,2017-03-07,-9,ES
7136,Deerpark,935,909,2017-03-07,26,MS
7137,Double File Trail,658,560,2017-03-07,98,ES
7138,DAEP,11,0,2017-03-07,11,Other
7139,England,988,956,2017-03-07,32,ES
7140,Fern Bluff,638,628,2017-03-07,10,ES
7141,Forest Creek,850,808,2017-03-07,42,ES
7142,Forest North,351,405,2017-03-07,-54,ES
7143,Gattis,693,719,2017-03-07,-26,ES
7144,Great Oaks,713,686,2017-03-07,27,ES
7145,Grisham,723,676,2017-03-07,47,MS
7146,Hernandez,795,777,2017-03-07,18,MS
7147,Herrington,996,935,2017-03-07,61,ES
7148,Hopewell,1073,1079,2017-03-07,-6,MS
7149,JJAEP,10,11,2017-03-07,-1,Other
7150,Johnson,540,502,2017-03-07,38,ES
7151,Jollyville,450,468,2017-03-07,-18,ES
7152,Laurel Mountain,790,811,2017-03-07,-21,ES
7153,Live Oak,552,589,2017-03-07,-37,ES
7154,McNeil,2617,2701,2017-03-07,-84,HS
7155,Old Town,796,637,2017-03-07,159,ES
7156,Pond Springs,667,620,2017-03-07,47,ES
7157,Purple Sage,398,341,2017-03-07,57,ES
7158,Round Rock Opportunity Center,129,41,2017-03-07,88,Other
7159,Ridgeview,1374,1369,2017-03-07,5,MS
7160,Robertson,445,466,2017-03-07,-21,ES
7161,Round Rock,3162,3319,2017-03-07,-157,HS
7162,Sommer,1197,1127,2017-03-07,70,ES
7163,Spicewood,827,819,2017-03-07,8,ES
7164,Stony Point,2575,2664,2017-03-07,-89,HS
7165,Success,321,346,2017-03-07,-25,HS
7166,Teravista,851,867,2017-03-07,-16,ES
7167,Union Hill,790,796,2017-03-07,-6,ES
7168,Voigt,565,510,2017-03-07,55,ES
7169,Walsh,1688,1657,2017-03-07,31,MS
7170,Wells Branch,502,485,2017-03-07,17,ES
7171,Westwood,2661,2736,2017-03-07,-75,HS
7172,LOTT,12,15,2017-03-07,-3,Other
7173,Anderson Mill,510,522,2017-03-21,-12,ES
7174,Berkman,454,491,2017-03-21,-37,ES
7175,Blackland Prairie,785,767,2017-03-21,18,ES
7176,Bluebonnet,421,546,2017-03-21,-125,ES
7177,Brushy Creek,820,831,2017-03-21,-11,ES
7178,C.D. Fulkes,679,712,2017-03-21,-33,MS
7179,Cactus Ranch,1012,1001,2017-03-21,11,ES
7180,Caldwell Heights,680,671,2017-03-21,9,ES
7181,Callison,809,805,2017-03-21,4,ES
7182,Canyon Creek,432,412,2017-03-21,20,ES
7183,Canyon Vista,1355,1410,2017-03-21,-55,MS
7184,Caraway,787,746,2017-03-21,41,ES
7185,Cedar Ridge,2678,2790,2017-03-21,-112,HS
7186,Cedar Valley,1446,1458,2017-03-21,-12,MS
7187,Chandler Oaks,548,495,2017-03-21,53,ES
7188,Chisholm Trail,1055,1026,2017-03-21,29,MS
7189,Deepwood,349,355,2017-03-21,-6,ES
7190,Deerpark,931,909,2017-03-21,22,MS
7191,Double File Trail,663,560,2017-03-21,103,ES
7192,DAEP,12,0,2017-03-21,12,Other
7193,England,986,956,2017-03-21,30,ES
7194,Fern Bluff,636,628,2017-03-21,8,ES
7195,Forest Creek,852,808,2017-03-21,44,ES
7196,Forest North,349,405,2017-03-21,-56,ES
7197,Gattis,694,719,2017-03-21,-25,ES
7198,Great Oaks,714,686,2017-03-21,28,ES
7199,Grisham,721,676,2017-03-21,45,MS
7200,Hernandez,795,777,2017-03-21,18,MS
7201,Herrington,992,935,2017-03-21,57,ES
7202,Hopewell,1079,1079,2017-03-21,0,MS
7203,JJAEP,12,11,2017-03-21,1,Other
7204,Johnson,546,502,2017-03-21,44,ES
7205,Jollyville,447,468,2017-03-21,-21,ES
7206,Laurel Mountain,795,811,2017-03-21,-16,ES
7207,Live Oak,553,589,2017-03-21,-36,ES
7208,McNeil,2623,2701,2017-03-21,-78,HS
7209,Old Town,797,637,2017-03-21,160,ES
7210,Pond Springs,672,620,2017-03-21,52,ES
7211,Purple Sage,399,341,2017-03-21,58,ES
7212,Round Rock Opportunity Center,128,41,2017-03-21,87,Other
7213,Ridgeview,1375,1369,2017-03-21,6,MS
7214,Robertson,444,466,2017-03-21,-22,ES
7215,Round Rock,3168,3319,2017-03-21,-151,HS
7216,Sommer,1196,1127,2017-03-21,69,ES
7217,Spicewood,828,819,2017-03-21,9,ES
7218,Stony Point,2568,2664,2017-03-21,-96,HS
7219,Success,319,346,2017-03-21,-27,HS
7220,Teravista,852,867,2017-03-21,-15,ES
7221,Union Hill,799,796,2017-03-21,3,ES
7222,Voigt,561,510,2017-03-21,51,ES
7223,Walsh,1689,1657,2017-03-21,32,MS
7224,Wells Branch,498,485,2017-03-21,13,ES
7225,Westwood,2659,2736,2017-03-21,-77,HS
7226,LOTT,10,15,2017-03-21,-5,Other
7227,Anderson Mill,515,522,2017-03-28,-7,ES
7228,Berkman,454,491,2017-03-28,-37,ES
7229,Blackland Prairie,785,767,2017-03-28,18,ES
7230,Bluebonnet,418,546,2017-03-28,-128,ES
7231,Brushy Creek,824,831,2017-03-28,-7,ES
7232,C.D. Fulkes,679,712,2017-03-28,-33,MS
7233,Cactus Ranch,1013,1001,2017-03-28,12,ES
7234,Caldwell Heights,678,671,2017-03-28,7,ES
7235,Callison,808,805,2017-03-28,3,ES
7236,Canyon Creek,432,412,2017-03-28,20,ES
7237,Canyon Vista,1353,1410,2017-03-28,-57,MS
7238,Caraway,788,746,2017-03-28,42,ES
7239,Cedar Ridge,2676,2790,2017-03-28,-114,HS
7240,Cedar Valley,1446,1458,2017-03-28,-12,MS
7241,Chandler Oaks,549,495,2017-03-28,54,ES
7242,Chisholm Trail,1052,1026,2017-03-28,26,MS
7243,Deepwood,352,355,2017-03-28,-3,ES
7244,Deerpark,932,909,2017-03-28,23,MS
7245,Double File Trail,663,560,2017-03-28,103,ES
7246,DAEP,13,0,2017-03-28,13,Other
7247,England,986,956,2017-03-28,30,ES
7248,Fern Bluff,636,628,2017-03-28,8,ES
7249,Forest Creek,851,808,2017-03-28,43,ES
7250,Forest North,346,405,2017-03-28,-59,ES
7251,Gattis,693,719,2017-03-28,-26,ES
7252,Great Oaks,716,686,2017-03-28,30,ES
7253,Grisham,720,676,2017-03-28,44,MS
7254,Hernandez,799,777,2017-03-28,22,MS
7255,Herrington,994,935,2017-03-28,59,ES
7256,Hopewell,1079,1079,2017-03-28,0,MS
7257,JJAEP,10,11,2017-03-28,-1,Other
7258,Johnson,552,502,2017-03-28,50,ES
7259,Jollyville,448,468,2017-03-28,-20,ES
7260,Laurel Mountain,796,811,2017-03-28,-15,ES
7261,Live Oak,554,589,2017-03-28,-35,ES
7262,McNeil,2623,2701,2017-03-28,-78,HS
7263,Old Town,798,637,2017-03-28,161,ES
7264,Pond Springs,673,620,2017-03-28,53,ES
7265,Purple Sage,397,341,2017-03-28,56,ES
7266,Round Rock Opportunity Center,123,41,2017-03-28,82,Other
7267,Ridgeview,1376,1369,2017-03-28,7,MS
7268,Robertson,444,466,2017-03-28,-22,ES
7269,Round Rock,3170,3319,2017-03-28,-149,HS
7270,Sommer,1198,1127,2017-03-28,71,ES
7271,Spicewood,828,819,2017-03-28,9,ES
7272,Stony Point,2571,2664,2017-03-28,-93,HS
7273,Success,308,346,2017-03-28,-38,HS
7274,Teravista,853,867,2017-03-28,-14,ES
7275,Union Hill,794,796,2017-03-28,-2,ES
7276,Voigt,561,510,2017-03-28,51,ES
7277,Walsh,1689,1657,2017-03-28,32,MS
7278,Wells Branch,502,485,2017-03-28,17,ES
7279,Westwood,2658,2736,2017-03-28,-78,HS
7280,LOTT,11,15,2017-03-28,-4,Other
7281,Anderson Mill,512,522,2017-04-04,-10,ES
7282,Berkman,456,491,2017-04-04,-35,ES
7283,Blackland Prairie,788,767,2017-04-04,21,ES
7284,Bluebonnet,417,546,2017-04-04,-129,ES
7285,Brushy Creek,824,831,2017-04-04,-7,ES
7286,C.D. Fulkes,676,712,2017-04-04,-36,MS
7287,Cactus Ranch,1013,1001,2017-04-04,12,ES
7288,Caldwell Heights,678,671,2017-04-04,7,ES
7289,Callison,802,805,2017-04-04,-3,ES
7290,Canyon Creek,432,412,2017-04-04,20,ES
7291,Canyon Vista,1351,1410,2017-04-04,-59,MS
7292,Caraway,790,746,2017-04-04,44,ES
7293,Cedar Ridge,2671,2790,2017-04-04,-119,HS
7294,Cedar Valley,1447,1458,2017-04-04,-11,MS
7295,Chandler Oaks,549,495,2017-04-04,54,ES
7296,Chisholm Trail,1054,1026,2017-04-04,28,MS
7297,Deepwood,351,355,2017-04-04,-4,ES
7298,Deerpark,927,909,2017-04-04,18,MS
7299,Double File Trail,663,560,2017-04-04,103,ES
7300,DAEP,13,0,2017-04-04,13,Other
7301,England,982,956,2017-04-04,26,ES
7302,Fern Bluff,635,628,2017-04-04,7,ES
7303,Forest Creek,851,808,2017-04-04,43,ES
7304,Forest North,347,405,2017-04-04,-58,ES
7305,Gattis,693,719,2017-04-04,-26,ES
7306,Great Oaks,716,686,2017-04-04,30,ES
7307,Grisham,724,676,2017-04-04,48,MS
7308,Hernandez,802,777,2017-04-04,25,MS
7309,Herrington,993,935,2017-04-04,58,ES
7310,Hopewell,1079,1079,2017-04-04,0,MS
7311,JJAEP,9,11,2017-04-04,-2,Other
7312,Johnson,553,502,2017-04-04,51,ES
7313,Jollyville,448,468,2017-04-04,-20,ES
7314,Laurel Mountain,797,811,2017-04-04,-14,ES
7315,Live Oak,552,589,2017-04-04,-37,ES
7316,McNeil,2616,2701,2017-04-04,-85,HS
7317,Old Town,799,637,2017-04-04,162,ES
7318,Pond Springs,669,620,2017-04-04,49,ES
7319,Purple Sage,396,341,2017-04-04,55,ES
7320,Round Rock Opportunity Center,130,41,2017-04-04,89,Other
7321,Ridgeview,1375,1369,2017-04-04,6,MS
7322,Robertson,443,466,2017-04-04,-23,ES
7323,Round Rock,3163,3319,2017-04-04,-156,HS
7324,Sommer,1196,1127,2017-04-04,69,ES
7325,Spicewood,828,819,2017-04-04,9,ES
7326,Stony Point,2569,2664,2017-04-04,-95,HS
7327,Success,298,346,2017-04-04,-48,HS
7328,Teravista,854,867,2017-04-04,-13,ES
7329,Union Hill,790,796,2017-04-04,-6,ES
7330,Voigt,563,510,2017-04-04,53,ES
7331,Walsh,1689,1657,2017-04-04,32,MS
7332,Wells Branch,500,485,2017-04-04,15,ES
7333,Westwood,2658,2736,2017-04-04,-78,HS
7334,LOTT,11,15,2017-04-04,-4,Other
7335,Anderson Mill,510,522,2017-04-11,-12,ES
7336,Berkman,458,491,2017-04-11,-33,ES
7337,Blackland Prairie,789,767,2017-04-11,22,ES
7338,Bluebonnet,419,546,2017-04-11,-127,ES
7339,Brushy Creek,824,831,2017-04-11,-7,ES
7340,C.D. Fulkes,674,712,2017-04-11,-38,MS
7341,Cactus Ranch,1012,1001,2017-04-11,11,ES
7342,Caldwell Heights,679,671,2017-04-11,8,ES
7343,Callison,800,805,2017-04-11,-5,ES
7344,Canyon Creek,433,412,2017-04-11,21,ES
7345,Canyon Vista,1351,1410,2017-04-11,-59,MS
7346,Caraway,790,746,2017-04-11,44,ES
7347,Cedar Ridge,2670,2790,2017-04-11,-120,HS
7348,Cedar Valley,1448,1458,2017-04-11,-10,MS
7349,Chandler Oaks,548,495,2017-04-11,53,ES
7350,Chisholm Trail,1055,1026,2017-04-11,29,MS
7351,Deepwood,352,355,2017-04-11,-3,ES
7352,Deerpark,930,909,2017-04-11,21,MS
7353,Double File Trail,663,560,2017-04-11,103,ES
7354,DAEP,10,0,2017-04-11,10,Other
7355,England,983,956,2017-04-11,27,ES
7356,Fern Bluff,635,628,2017-04-11,7,ES
7357,Forest Creek,851,808,2017-04-11,43,ES
7358,Forest North,347,405,2017-04-11,-58,ES
7359,Gattis,697,719,2017-04-11,-22,ES
7360,Great Oaks,717,686,2017-04-11,31,ES
7361,Grisham,724,676,2017-04-11,48,MS
7362,Hernandez,805,777,2017-04-11,28,MS
7363,Herrington,997,935,2017-04-11,62,ES
7364,Hopewell,1077,1079,2017-04-11,-2,MS
7365,JJAEP,6,11,2017-04-11,-5,Other
7366,Johnson,554,502,2017-04-11,52,ES
7367,Jollyville,450,468,2017-04-11,-18,ES
7368,Laurel Mountain,796,811,2017-04-11,-15,ES
7369,Live Oak,553,589,2017-04-11,-36,ES
7370,McNeil,2610,2701,2017-04-11,-91,HS
7371,Old Town,801,637,2017-04-11,164,ES
7372,Pond Springs,669,620,2017-04-11,49,ES
7373,Purple Sage,397,341,2017-04-11,56,ES
7374,Round Rock Opportunity Center,124,41,2017-04-11,83,Other
7375,Ridgeview,1375,1369,2017-04-11,6,MS
7376,Robertson,448,466,2017-04-11,-18,ES
7377,Round Rock,3155,3319,2017-04-11,-164,HS
7378,Sommer,1197,1127,2017-04-11,70,ES
7379,Spicewood,828,819,2017-04-11,9,ES
7380,Stony Point,2567,2664,2017-04-11,-97,HS
7381,Success,283,346,2017-04-11,-63,HS
7382,Teravista,853,867,2017-04-11,-14,ES
7383,Union Hill,793,796,2017-04-11,-3,ES
7384,Voigt,565,510,2017-04-11,55,ES
7385,Walsh,1688,1657,2017-04-11,31,MS
7386,Wells Branch,500,485,2017-04-11,15,ES
7387,Westwood,2657,2736,2017-04-11,-79,HS
7388,LOTT,12,15,2017-04-11,-3,Other
7389,Anderson Mill,513,522,2017-04-18,-9,ES
7390,Berkman,458,491,2017-04-18,-33,ES
7391,Blackland Prairie,790,767,2017-04-18,23,ES
7392,Bluebonnet,418,546,2017-04-18,-128,ES
7393,Brushy Creek,825,831,2017-04-18,-6,ES
7394,C.D. Fulkes,671,712,2017-04-18,-41,MS
7395,Cactus Ranch,1012,1001,2017-04-18,11,ES
7396,Caldwell Heights,679,671,2017-04-18,8,ES
7397,Callison,801,805,2017-04-18,-4,ES
7398,Canyon Creek,432,412,2017-04-18,20,ES
7399,Canyon Vista,1348,1410,2017-04-18,-62,MS
7400,Caraway,789,746,2017-04-18,43,ES
7401,Cedar Ridge,2668,2790,2017-04-18,-122,HS
7402,Cedar Valley,1448,1458,2017-04-18,-10,MS
7403,Chandler Oaks,548,495,2017-04-18,53,ES
7404,Chisholm Trail,1054,1026,2017-04-18,28,MS
7405,Deepwood,352,355,2017-04-18,-3,ES
7406,Deerpark,930,909,2017-04-18,21,MS
7407,Double File Trail,663,560,2017-04-18,103,ES
7408,DAEP,9,0,2017-04-18,9,Other
7409,England,987,956,2017-04-18,31,ES
7410,Fern Bluff,635,628,2017-04-18,7,ES
7411,Forest Creek,851,808,2017-04-18,43,ES
7412,Forest North,347,405,2017-04-18,-58,ES
7413,Gattis,696,719,2017-04-18,-23,ES
7414,Great Oaks,717,686,2017-04-18,31,ES
7415,Grisham,723,676,2017-04-18,47,MS
7416,Hernandez,806,777,2017-04-18,29,MS
7417,Herrington,997,935,2017-04-18,62,ES
7418,Hopewell,1076,1079,2017-04-18,-3,MS
7419,JJAEP,7,11,2017-04-18,-4,Other
7420,Johnson,554,502,2017-04-18,52,ES
7421,Jollyville,448,468,2017-04-18,-20,ES
7422,Laurel Mountain,795,811,2017-04-18,-16,ES
7423,Live Oak,556,589,2017-04-18,-33,ES
7424,McNeil,2605,2701,2017-04-18,-96,HS
7425,Old Town,801,637,2017-04-18,164,ES
7426,Pond Springs,668,620,2017-04-18,48,ES
7427,Purple Sage,397,341,2017-04-18,56,ES
7428,Round Rock Opportunity Center,131,41,2017-04-18,90,Other
7429,Ridgeview,1376,1369,2017-04-18,7,MS
7430,Robertson,449,466,2017-04-18,-17,ES
7431,Round Rock,3158,3319,2017-04-18,-161,HS
7432,Sommer,1197,1127,2017-04-18,70,ES
7433,Spicewood,830,819,2017-04-18,11,ES
7434,Stony Point,2560,2664,2017-04-18,-104,HS
7435,Success,278,346,2017-04-18,-68,HS
7436,Teravista,854,867,2017-04-18,-13,ES
7437,Union Hill,793,796,2017-04-18,-3,ES
7438,Voigt,563,510,2017-04-18,53,ES
7439,Walsh,1687,1657,2017-04-18,30,MS
7440,Wells Branch,500,485,2017-04-18,15,ES
7441,Westwood,2657,2736,2017-04-18,-79,HS
7442,LOTT,8,15,2017-04-18,-7,Other
7443,Anderson Mill,513,522,2017-04-25,-9,ES
7444,Berkman,457,491,2017-04-25,-34,ES
7445,Blackland Prairie,790,767,2017-04-25,23,ES
7446,Bluebonnet,416,546,2017-04-25,-130,ES
7447,Brushy Creek,823,831,2017-04-25,-8,ES
7448,C.D. Fulkes,672,712,2017-04-25,-40,MS
7449,Cactus Ranch,1013,1001,2017-04-25,12,ES
7450,Caldwell Heights,679,671,2017-04-25,8,ES
7451,Callison,802,805,2017-04-25,-3,ES
7452,Canyon Creek,431,412,2017-04-25,19,ES
7453,Canyon Vista,1348,1410,2017-04-25,-62,MS
7454,Caraway,789,746,2017-04-25,43,ES
7455,Cedar Ridge,2668,2790,2017-04-25,-122,HS
7456,Cedar Valley,1450,1458,2017-04-25,-8,MS
7457,Chandler Oaks,550,495,2017-04-25,55,ES
7458,Chisholm Trail,1052,1026,2017-04-25,26,MS
7459,Deepwood,353,355,2017-04-25,-2,ES
7460,Deerpark,923,909,2017-04-25,14,MS
7461,Double File Trail,660,560,2017-04-25,100,ES
7462,DAEP,12,0,2017-04-25,12,Other
7463,England,987,956,2017-04-25,31,ES
7464,Fern Bluff,635,628,2017-04-25,7,ES
7465,Forest Creek,854,808,2017-04-25,46,ES
7466,Forest North,347,405,2017-04-25,-58,ES
7467,Gattis,694,719,2017-04-25,-25,ES
7468,Great Oaks,717,686,2017-04-25,31,ES
7469,Grisham,728,676,2017-04-25,52,MS
7470,Hernandez,803,777,2017-04-25,26,MS
7471,Herrington,1000,935,2017-04-25,65,ES
7472,Hopewell,1077,1079,2017-04-25,-2,MS
7473,JJAEP,8,11,2017-04-25,-3,Other
7474,Johnson,554,502,2017-04-25,52,ES
7475,Jollyville,446,468,2017-04-25,-22,ES
7476,Laurel Mountain,797,811,2017-04-25,-14,ES
7477,Live Oak,555,589,2017-04-25,-34,ES
7478,McNeil,2598,2701,2017-04-25,-103,HS
7479,Old Town,801,637,2017-04-25,164,ES
7480,Pond Springs,670,620,2017-04-25,50,ES
7481,Purple Sage,396,341,2017-04-25,55,ES
7482,Round Rock Opportunity Center,132,41,2017-04-25,91,Other
7483,Ridgeview,1374,1369,2017-04-25,5,MS
7484,Robertson,448,466,2017-04-25,-18,ES
7485,Round Rock,3154,3319,2017-04-25,-165,HS
7486,Sommer,1198,1127,2017-04-25,71,ES
7487,Spicewood,830,819,2017-04-25,11,ES
7488,Stony Point,2561,2664,2017-04-25,-103,HS
7489,Success,265,346,2017-04-25,-81,HS
7490,Teravista,855,867,2017-04-25,-12,ES
7491,Union Hill,794,796,2017-04-25,-2,ES
7492,Voigt,560,510,2017-04-25,50,ES
7493,Walsh,1687,1657,2017-04-25,30,MS
7494,Wells Branch,502,485,2017-04-25,17,ES
7495,Westwood,2652,2736,2017-04-25,-84,HS
7496,LOTT,8,15,2017-04-25,-7,Other
7497,Anderson Mill,514,522,2017-05-02,-8,ES
7498,Berkman,452,491,2017-05-02,-39,ES
7499,Blackland Prairie,791,767,2017-05-02,24,ES
7500,Bluebonnet,416,546,2017-05-02,-130,ES
7501,Brushy Creek,821,831,2017-05-02,-10,ES
7502,C.D. Fulkes,673,712,2017-05-02,-39,MS
7503,Cactus Ranch,1011,1001,2017-05-02,10,ES
7504,Caldwell Heights,679,671,2017-05-02,8,ES
7505,Callison,802,805,2017-05-02,-3,ES
7506,Canyon Creek,431,412,2017-05-02,19,ES
7507,Canyon Vista,1347,1410,2017-05-02,-63,MS
7508,Caraway,789,746,2017-05-02,43,ES
7509,Cedar Ridge,2667,2790,2017-05-02,-123,HS
7510,Cedar Valley,1451,1458,2017-05-02,-7,MS
7511,Chandler Oaks,551,495,2017-05-02,56,ES
7512,Chisholm Trail,1051,1026,2017-05-02,25,MS
7513,Deepwood,352,355,2017-05-02,-3,ES
7514,Deerpark,920,909,2017-05-02,11,MS
7515,Double File Trail,660,560,2017-05-02,100,ES
7516,DAEP,12,0,2017-05-02,12,Other
7517,England,991,956,2017-05-02,35,ES
7518,Fern Bluff,635,628,2017-05-02,7,ES
7519,Forest Creek,854,808,2017-05-02,46,ES
7520,Forest North,346,405,2017-05-02,-59,ES
7521,Gattis,695,719,2017-05-02,-24,ES
7522,Great Oaks,719,686,2017-05-02,33,ES
7523,Grisham,728,676,2017-05-02,52,MS
7524,Hernandez,801,777,2017-05-02,24,MS
7525,Herrington,999,935,2017-05-02,64,ES
7526,Hopewell,1078,1079,2017-05-02,-1,MS
7527,JJAEP,9,11,2017-05-02,-2,Other
7528,Johnson,549,502,2017-05-02,47,ES
7529,Jollyville,445,468,2017-05-02,-23,ES
7530,Laurel Mountain,797,811,2017-05-02,-14,ES
7531,Live Oak,555,589,2017-05-02,-34,ES
7532,McNeil,2596,2701,2017-05-02,-105,HS
7533,Old Town,798,637,2017-05-02,161,ES
7534,Pond Springs,668,620,2017-05-02,48,ES
7535,Purple Sage,397,341,2017-05-02,56,ES
7536,Round Rock Opportunity Center,122,41,2017-05-02,81,Other
7537,Ridgeview,1373,1369,2017-05-02,4,MS
7538,Robertson,448,466,2017-05-02,-18,ES
7539,Round Rock,3156,3319,2017-05-02,-163,HS
7540,Sommer,1201,1127,2017-05-02,74,ES
7541,Spicewood,830,819,2017-05-02,11,ES
7542,Stony Point,2562,2664,2017-05-02,-102,HS
7543,Success,251,346,2017-05-02,-95,HS
7544,Teravista,854,867,2017-05-02,-13,ES
7545,Union Hill,792,796,2017-05-02,-4,ES
7546,Voigt,563,510,2017-05-02,53,ES
7547,Walsh,1688,1657,2017-05-02,31,MS
7548,Wells Branch,501,485,2017-05-02,16,ES
7549,Westwood,2649,2736,2017-05-02,-87,HS
7550,LOTT,8,15,2017-05-02,-7,Other
7551,Anderson Mill,513,522,2017-05-09,-9,ES
7552,Berkman,453,491,2017-05-09,-38,ES
7553,Blackland Prairie,792,767,2017-05-09,25,ES
7554,Bluebonnet,418,546,2017-05-09,-128,ES
7555,Brushy Creek,820,831,2017-05-09,-11,ES
7556,C.D. Fulkes,674,712,2017-05-09,-38,MS
7557,Cactus Ranch,1012,1001,2017-05-09,11,ES
7558,Caldwell Heights,678,671,2017-05-09,7,ES
7559,Callison,802,805,2017-05-09,-3,ES
7560,Canyon Creek,431,412,2017-05-09,19,ES
7561,Canyon Vista,1348,1410,2017-05-09,-62,MS
7562,Caraway,790,746,2017-05-09,44,ES
7563,Cedar Ridge,2659,2790,2017-05-09,-131,HS
7564,Cedar Valley,1448,1458,2017-05-09,-10,MS
7565,Chandler Oaks,551,495,2017-05-09,56,ES
7566,Chisholm Trail,1051,1026,2017-05-09,25,MS
7567,Deepwood,352,355,2017-05-09,-3,ES
7568,Deerpark,918,909,2017-05-09,9,MS
7569,Double File Trail,660,560,2017-05-09,100,ES
7570,DAEP,13,0,2017-05-09,13,Other
7571,England,992,956,2017-05-09,36,ES
7572,Fern Bluff,636,628,2017-05-09,8,ES
7573,Forest Creek,854,808,2017-05-09,46,ES
7574,Forest North,345,405,2017-05-09,-60,ES
7575,Gattis,693,719,2017-05-09,-26,ES
7576,Great Oaks,719,686,2017-05-09,33,ES
7577,Grisham,727,676,2017-05-09,51,MS
7578,Hernandez,801,777,2017-05-09,24,MS
7579,Herrington,998,935,2017-05-09,63,ES
7580,Hopewell,1078,1079,2017-05-09,-1,MS
7581,JJAEP,9,11,2017-05-09,-2,Other
7582,Johnson,552,502,2017-05-09,50,ES
7583,Jollyville,446,468,2017-05-09,-22,ES
7584,Laurel Mountain,796,811,2017-05-09,-15,ES
7585,Live Oak,554,589,2017-05-09,-35,ES
7586,McNeil,2591,2701,2017-05-09,-110,HS
7587,Old Town,798,637,2017-05-09,161,ES
7588,Pond Springs,668,620,2017-05-09,48,ES
7589,Purple Sage,396,341,2017-05-09,55,ES
7590,Round Rock Opportunity Center,127,41,2017-05-09,86,Other
7591,Ridgeview,1373,1369,2017-05-09,4,MS
7592,Robertson,447,466,2017-05-09,-19,ES
7593,Round Rock,3155,3319,2017-05-09,-164,HS
7594,Sommer,1199,1127,2017-05-09,72,ES
7595,Spicewood,829,819,2017-05-09,10,ES
7596,Stony Point,2564,2664,2017-05-09,-100,HS
7597,Success,223,346,2017-05-09,-123,HS
7598,Teravista,854,867,2017-05-09,-13,ES
7599,Union Hill,788,796,2017-05-09,-8,ES
7600,Voigt,564,510,2017-05-09,54,ES
7601,Walsh,1687,1657,2017-05-09,30,MS
7602,Wells Branch,501,485,2017-05-09,16,ES
7603,Westwood,2650,2736,2017-05-09,-86,HS
7604,LOTT,9,15,2017-05-09,-6,Other
7605,Anderson Mill,516,522,2017-05-16,-6,ES
7606,Berkman,451,491,2017-05-16,-40,ES
7607,Blackland Prairie,792,767,2017-05-16,25,ES
7608,Bluebonnet,418,546,2017-05-16,-128,ES
7609,Brushy Creek,818,831,2017-05-16,-13,ES
7610,C.D. Fulkes,674,712,2017-05-16,-38,MS
7611,Cactus Ranch,1010,1001,2017-05-16,9,ES
7612,Caldwell Heights,677,671,2017-05-16,6,ES
7613,Callison,802,805,2017-05-16,-3,ES
7614,Canyon Creek,432,412,2017-05-16,20,ES
7615,Canyon Vista,1349,1410,2017-05-16,-61,MS
7616,Caraway,794,746,2017-05-16,48,ES
7617,Cedar Ridge,2654,2790,2017-05-16,-136,HS
7618,Cedar Valley,1447,1458,2017-05-16,-11,MS
7619,Chandler Oaks,551,495,2017-05-16,56,ES
7620,Chisholm Trail,1050,1026,2017-05-16,24,MS
7621,Deepwood,352,355,2017-05-16,-3,ES
7622,Deerpark,920,909,2017-05-16,11,MS
7623,Double File Trail,656,560,2017-05-16,96,ES
7624,DAEP,12,0,2017-05-16,12,Other
7625,England,990,956,2017-05-16,34,ES
7626,Fern Bluff,637,628,2017-05-16,9,ES
7627,Forest Creek,853,808,2017-05-16,45,ES
7628,Forest North,349,405,2017-05-16,-56,ES
7629,Gattis,703,719,2017-05-16,-16,ES
7630,Great Oaks,721,686,2017-05-16,35,ES
7631,Grisham,729,676,2017-05-16,53,MS
7632,Hernandez,798,777,2017-05-16,21,MS
7633,Herrington,995,935,2017-05-16,60,ES
7634,Hopewell,1079,1079,2017-05-16,0,MS
7635,JJAEP,8,11,2017-05-16,-3,Other
7636,Johnson,555,502,2017-05-16,53,ES
7637,Jollyville,449,468,2017-05-16,-19,ES
7638,Laurel Mountain,795,811,2017-05-16,-16,ES
7639,Live Oak,554,589,2017-05-16,-35,ES
7640,McNeil,2587,2701,2017-05-16,-114,HS
7641,Old Town,799,637,2017-05-16,162,ES
7642,Pond Springs,668,620,2017-05-16,48,ES
7643,Purple Sage,397,341,2017-05-16,56,ES
7644,Round Rock Opportunity Center,135,41,2017-05-16,94,Other
7645,Ridgeview,1374,1369,2017-05-16,5,MS
7646,Robertson,446,466,2017-05-16,-20,ES
7647,Round Rock,3148,3319,2017-05-16,-171,HS
7648,Sommer,1199,1127,2017-05-16,72,ES
7649,Spicewood,828,819,2017-05-16,9,ES
7650,Stony Point,2563,2664,2017-05-16,-101,HS
7651,Success,211,346,2017-05-16,-135,HS
7652,Teravista,854,867,2017-05-16,-13,ES
7653,Union Hill,788,796,2017-05-16,-8,ES
7654,Voigt,565,510,2017-05-16,55,ES
7655,Walsh,1685,1657,2017-05-16,28,MS
7656,Wells Branch,500,485,2017-05-16,15,ES
7657,Westwood,2649,2736,2017-05-16,-87,HS
7658,LOTT,9,15,2017-05-16,-6,Other
7659,Anderson Mill,517,522,2017-05-23,-5,ES
7660,Berkman,449,491,2017-05-23,-42,ES
7661,Blackland Prairie,792,767,2017-05-23,25,ES
7662,Bluebonnet,418,546,2017-05-23,-128,ES
7663,Brushy Creek,817,831,2017-05-23,-14,ES
7664,C.D. Fulkes,673,712,2017-05-23,-39,MS
7665,Cactus Ranch,1010,1001,2017-05-23,9,ES
7666,Caldwell Heights,677,671,2017-05-23,6,ES
7667,Callison,803,805,2017-05-23,-2,ES
7668,Canyon Creek,432,412,2017-05-23,20,ES
7669,Canyon Vista,1348,1410,2017-05-23,-62,MS
7670,Caraway,794,746,2017-05-23,48,ES
7671,Cedar Ridge,2654,2790,2017-05-23,-136,HS
7672,Cedar Valley,1446,1458,2017-05-23,-12,MS
7673,Chandler Oaks,551,495,2017-05-23,56,ES
7674,Chisholm Trail,1050,1026,2017-05-23,24,MS
7675,Deepwood,352,355,2017-05-23,-3,ES
7676,Deerpark,920,909,2017-05-23,11,MS
7677,Double File Trail,656,560,2017-05-23,96,ES
7678,DAEP,13,0,2017-05-23,13,Other
7679,England,992,956,2017-05-23,36,ES
7680,Fern Bluff,637,628,2017-05-23,9,ES
7681,Forest Creek,853,808,2017-05-23,45,ES
7682,Forest North,349,405,2017-05-23,-56,ES
7683,Gattis,703,719,2017-05-23,-16,ES
7684,Great Oaks,721,686,2017-05-23,35,ES
7685,Grisham,729,676,2017-05-23,53,MS
7686,Hernandez,797,777,2017-05-23,20,MS
7687,Herrington,993,935,2017-05-23,58,ES
7688,Hopewell,1079,1079,2017-05-23,0,MS
7689,JJAEP,8,11,2017-05-23,-3,Other
7690,Johnson,557,502,2017-05-23,55,ES
7691,Jollyville,449,468,2017-05-23,-19,ES
7692,Laurel Mountain,795,811,2017-05-23,-16,ES
7693,Live Oak,551,589,2017-05-23,-38,ES
7694,McNeil,2585,2701,2017-05-23,-116,HS
7695,Old Town,799,637,2017-05-23,162,ES
7696,Pond Springs,669,620,2017-05-23,49,ES
7697,Purple Sage,397,341,2017-05-23,56,ES
7698,Round Rock Opportunity Center,140,41,2017-05-23,99,Other
7699,Ridgeview,1376,1369,2017-05-23,7,MS
7700,Robertson,446,466,2017-05-23,-20,ES
7701,Round Rock,3146,3319,2017-05-23,-173,HS
7702,Sommer,1200,1127,2017-05-23,73,ES
7703,Spicewood,828,819,2017-05-23,9,ES
7704,Stony Point,2561,2664,2017-05-23,-103,HS
7705,Success,194,346,2017-05-23,-152,HS
7706,Teravista,857,867,2017-05-23,-10,ES
7707,Union Hill,787,796,2017-05-23,-9,ES
7708,Voigt,557,510,2017-05-23,47,ES
7709,Walsh,1684,1657,2017-05-23,27,MS
7710,Wells Branch,501,485,2017-05-23,16,ES
7711,Westwood,2649,2736,2017-05-23,-87,HS
7712,LOTT,10,15,2017-05-23,-5,Other
7713,Anderson Mill,514,522,2017-05-30,-8,ES
7714,Berkman,448,491,2017-05-30,-43,ES
7715,Blackland Prairie,793,767,2017-05-30,26,ES
7716,Bluebonnet,416,546,2017-05-30,-130,ES
7717,Brushy Creek,818,831,2017-05-30,-13,ES
7718,C.D. Fulkes,672,712,2017-05-30,-40,MS
7719,Cactus Ranch,1010,1001,2017-05-30,9,ES
7720,Caldwell Heights,677,671,2017-05-30,6,ES
7721,Callison,803,805,2017-05-30,-2,ES
7722,Canyon Creek,432,412,2017-05-30,20,ES
7723,Canyon Vista,1348,1410,2017-05-30,-62,MS
7724,Caraway,794,746,2017-05-30,48,ES
7725,Cedar Ridge,2651,2790,2017-05-30,-139,HS
7726,Cedar Valley,1445,1458,2017-05-30,-13,MS
7727,Chandler Oaks,551,495,2017-05-30,56,ES
7728,Chisholm Trail,1050,1026,2017-05-30,24,MS
7729,Deepwood,352,355,2017-05-30,-3,ES
7730,Deerpark,920,909,2017-05-30,11,MS
7731,Double File Trail,656,560,2017-05-30,96,ES
7732,DAEP,12,0,2017-05-30,12,Other
7733,England,991,956,2017-05-30,35,ES
7734,Fern Bluff,637,628,2017-05-30,9,ES
7735,Forest Creek,853,808,2017-05-30,45,ES
7736,Forest North,348,405,2017-05-30,-57,ES
7737,Gattis,703,719,2017-05-30,-16,ES
7738,Great Oaks,719,686,2017-05-30,33,ES
7739,Grisham,729,676,2017-05-30,53,MS
7740,Hernandez,794,777,2017-05-30,17,MS
7741,Herrington,993,935,2017-05-30,58,ES
7742,Hopewell,1079,1079,2017-05-30,0,MS
7743,JJAEP,8,11,2017-05-30,-3,Other
7744,Johnson,557,502,2017-05-30,55,ES
7745,Jollyville,445,468,2017-05-30,-23,ES
7746,Laurel Mountain,795,811,2017-05-30,-16,ES
7747,Live Oak,551,589,2017-05-30,-38,ES
7748,McNeil,2582,2701,2017-05-30,-119,HS
7749,Old Town,800,637,2017-05-30,163,ES
7750,Pond Springs,668,620,2017-05-30,48,ES
7751,Purple Sage,397,341,2017-05-30,56,ES
7752,Round Rock Opportunity Center,143,41,2017-05-30,102,Other
7753,Ridgeview,1375,1369,2017-05-30,6,MS
7754,Robertson,445,466,2017-05-30,-21,ES
7755,Round Rock,3143,3319,2017-05-30,-176,HS
7756,Sommer,1200,1127,2017-05-30,73,ES
7757,Spicewood,829,819,2017-05-30,10,ES
7758,Stony Point,2558,2664,2017-05-30,-106,HS
7759,Success,162,346,2017-05-30,-184,HS
7760,Teravista,855,867,2017-05-30,-12,ES
7761,Union Hill,784,796,2017-05-30,-12,ES
7762,Voigt,558,510,2017-05-30,48,ES
7763,Walsh,1684,1657,2017-05-30,27,MS
7764,Wells Branch,499,485,2017-05-30,14,ES
7765,Westwood,2648,2736,2017-05-30,-88,HS
7766,LOTT,9,15,2017-05-30,-6,Other
7767,Johnson,700,553,2017-08-22,147,ES
7768,Anderson Mill,494,533,2017-08-22,-39,ES
7769,Berkman,427,475,2017-08-22,-48,ES
7770,Blackland Prairie,776,742,2017-08-22,34,ES
7771,Bluebonnet,346,424,2017-08-22,-78,ES
7772,Brushy Creek,731,786,2017-08-22,-55,ES
7773,C.D. Fulkes,656,682,2017-08-22,-26,MS
7774,Cactus Ranch,953,948,2017-08-22,5,ES
7775,Caldwell Heights,691,651,2017-08-22,40,ES
7776,Callison,758,821,2017-08-22,-63,ES
7777,Canyon Creek,421,437,2017-08-22,-16,ES
7778,Canyon Vista,1321,1353,2017-08-22,-32,MS
7779,Caraway,789,769,2017-08-22,20,ES
7780,Cedar Ridge,2718,2712,2017-08-22,6,HS
7781,Cedar Valley,1255,1231,2017-08-22,24,MS
7782,Chandler Oaks,560,556,2017-08-22,4,ES
7783,Chisholm Trail,922,868,2017-08-22,54,MS
7784,DAEP,0,9,2017-08-22,-9,Other
7785,Deepwood,343,334,2017-08-22,9,ES
7786,Deerpark,882,868,2017-08-22,14,MS
7787,Double File Trail,610,659,2017-08-22,-49,ES
7788,Early College,214,219,2017-08-22,-5,HS
7789,England,1056,1029,2017-08-22,27,ES
7790,Fern Bluff,600,593,2017-08-22,7,ES
7791,Forest Creek,824,844,2017-08-22,-20,ES
7792,Forest North,326,367,2017-08-22,-41,ES
7793,Gattis,706,714,2017-08-22,-8,ES
7794,Great Oaks,703,692,2017-08-22,11,ES
7795,Grisham,617,622,2017-08-22,-5,MS
7796,Hernandez,726,778,2017-08-22,-52,MS
7797,Herrington,1011,1100,2017-08-22,-89,ES
7798,Hopewell,1095,1088,2017-08-22,7,MS
7799,JJAEP,7,5,2017-08-22,2,Other
7800,Jollyville,424,439,2017-08-22,-15,ES
7801,Laurel Mountain,732,773,2017-08-22,-41,ES
7802,Live Oak,495,582,2017-08-22,-87,ES
7803,McNeil,2654,2726,2017-08-22,-72,HS
7804,Old Town,735,745,2017-08-22,-10,ES
7805,Pearson Ranch,638,803,2017-08-22,-165,MS
7806,Pond Springs,615,672,2017-08-22,-57,ES
7807,Purple Sage,420,407,2017-08-22,13,ES
7808,Round Rock Opportunity Center,38,118,2017-08-22,-80,Other
7809,Ridgeview,1342,1320,2017-08-22,22,MS
7810,Robertson,414,444,2017-08-22,-30,ES
7811,Round Rock,3328,3374,2017-08-22,-46,HS
7812,Sommer,1201,1223,2017-08-22,-22,ES
7813,Spicewood,795,805,2017-08-22,-10,ES
7814,Stony Point,2574,2615,2017-08-22,-41,HS
7815,Success,279,341,2017-08-22,-62,HS
7816,Teravista,860,845,2017-08-22,15,ES
7817,Union Hill,717,745,2017-08-22,-28,ES
7818,Voigt,516,569,2017-08-22,-53,ES
7819,Walsh,1443,1426,2017-08-22,17,MS
7820,Wells Branch,449,486,2017-08-22,-37,ES
7821,Westwood,2710,2732,2017-08-22,-22,HS
7822,LOTT,6,11,2017-08-22,-5,Other
7823,Johnson,722,553,2017-08-29,169,ES
7824,Anderson Mill,510,533,2017-08-29,-23,ES
7825,Berkman,444,475,2017-08-29,-31,ES
7826,Blackland Prairie,791,742,2017-08-29,49,ES
7827,Bluebonnet,352,424,2017-08-29,-72,ES
7828,Brushy Creek,743,786,2017-08-29,-43,ES
7829,C.D. Fulkes,684,682,2017-08-29,2,MS
7830,Cactus Ranch,967,948,2017-08-29,19,ES
7831,Caldwell Heights,702,651,2017-08-29,51,ES
7832,Callison,783,821,2017-08-29,-38,ES
7833,Canyon Creek,426,437,2017-08-29,-11,ES
7834,Canyon Vista,1339,1353,2017-08-29,-14,MS
7835,Caraway,806,769,2017-08-29,37,ES
7836,Cedar Ridge,2761,2712,2017-08-29,49,HS
7837,Cedar Valley,1267,1231,2017-08-29,36,MS
7838,Chandler Oaks,564,556,2017-08-29,8,ES
7839,Chisholm Trail,938,868,2017-08-29,70,MS
7840,DAEP,0,9,2017-08-29,-9,Other
7841,Deepwood,350,334,2017-08-29,16,ES
7842,Deerpark,909,868,2017-08-29,41,MS
7843,Double File Trail,623,659,2017-08-29,-36,ES
7844,Early College,219,219,2017-08-29,0,HS
7845,England,1081,1029,2017-08-29,52,ES
7846,Fern Bluff,606,593,2017-08-29,13,ES
7847,Forest Creek,832,844,2017-08-29,-12,ES
7848,Forest North,339,367,2017-08-29,-28,ES
7849,Gattis,733,714,2017-08-29,19,ES
7850,Great Oaks,710,692,2017-08-29,18,ES
7851,Grisham,642,622,2017-08-29,20,MS
7852,Hernandez,745,778,2017-08-29,-33,MS
7853,Herrington,1025,1100,2017-08-29,-75,ES
7854,Hopewell,1111,1088,2017-08-29,23,MS
7855,JJAEP,6,5,2017-08-29,1,Other
7856,Jollyville,442,439,2017-08-29,3,ES
7857,Laurel Mountain,747,773,2017-08-29,-26,ES
7858,Live Oak,519,582,2017-08-29,-63,ES
7859,McNeil,2696,2726,2017-08-29,-30,HS
7860,Old Town,749,745,2017-08-29,4,ES
7861,Pearson Ranch,650,803,2017-08-29,-153,MS
7862,Pond Springs,637,672,2017-08-29,-35,ES
7863,Purple Sage,436,407,2017-08-29,29,ES
7864,Round Rock Opportunity Center,45,118,2017-08-29,-73,Other
7865,Ridgeview,1352,1320,2017-08-29,32,MS
7866,Robertson,433,444,2017-08-29,-11,ES
7867,Round Rock,3371,3374,2017-08-29,-3,HS
7868,Sommer,1224,1223,2017-08-29,1,ES
7869,Spicewood,808,805,2017-08-29,3,ES
7870,Stony Point,2620,2615,2017-08-29,5,HS
7871,Success,307,341,2017-08-29,-34,HS
7872,Teravista,866,845,2017-08-29,21,ES
7873,Union Hill,735,745,2017-08-29,-10,ES
7874,Voigt,528,569,2017-08-29,-41,ES
7875,Walsh,1462,1426,2017-08-29,36,MS
7876,Wells Branch,468,486,2017-08-29,-18,ES
7877,Westwood,2744,2732,2017-08-29,12,HS
7878,LOTT,2,11,2017-08-29,-9,Other
7879,Johnson,726,553,2017-09-05,173,ES
7880,Anderson Mill,515,533,2017-09-05,-18,ES
7881,Berkman,452,475,2017-09-05,-23,ES
7882,Blackland Prairie,794,742,2017-09-05,52,ES
7883,Bluebonnet,356,424,2017-09-05,-68,ES
7884,Brushy Creek,744,786,2017-09-05,-42,ES
7885,C.D. Fulkes,695,682,2017-09-05,13,MS
7886,Cactus Ranch,972,948,2017-09-05,24,ES
7887,Caldwell Heights,709,651,2017-09-05,58,ES
7888,Callison,791,821,2017-09-05,-30,ES
7889,Canyon Creek,427,437,2017-09-05,-10,ES
7890,Canyon Vista,1342,1353,2017-09-05,-11,MS
7891,Caraway,810,769,2017-09-05,41,ES
7892,Cedar Ridge,2763,2712,2017-09-05,51,HS
7893,Cedar Valley,1269,1231,2017-09-05,38,MS
7894,Chandler Oaks,563,556,2017-09-05,7,ES
7895,Chisholm Trail,942,868,2017-09-05,74,MS
7896,DAEP,0,9,2017-09-05,-9,Other
7897,Deepwood,349,334,2017-09-05,15,ES
7898,Deerpark,909,868,2017-09-05,41,MS
7899,Double File Trail,624,659,2017-09-05,-35,ES
7900,Early College,220,219,2017-09-05,1,HS
7901,England,1088,1029,2017-09-05,59,ES
7902,Fern Bluff,609,593,2017-09-05,16,ES
7903,Forest Creek,832,844,2017-09-05,-12,ES
7904,Forest North,345,367,2017-09-05,-22,ES
7905,Gattis,737,714,2017-09-05,23,ES
7906,Great Oaks,712,692,2017-09-05,20,ES
7907,Grisham,645,622,2017-09-05,23,MS
7908,Hernandez,747,778,2017-09-05,-31,MS
7909,Herrington,1028,1100,2017-09-05,-72,ES
7910,Hopewell,1115,1088,2017-09-05,27,MS
7911,JJAEP,6,5,2017-09-05,1,Other
7912,Jollyville,445,439,2017-09-05,6,ES
7913,Laurel Mountain,748,773,2017-09-05,-25,ES
7914,Live Oak,531,582,2017-09-05,-51,ES
7915,McNeil,2709,2726,2017-09-05,-17,HS
7916,Old Town,753,745,2017-09-05,8,ES
7917,Pearson Ranch,653,803,2017-09-05,-150,MS
7918,Pond Springs,635,672,2017-09-05,-37,ES
7919,Purple Sage,438,407,2017-09-05,31,ES
7920,Round Rock Opportunity Center,43,118,2017-09-05,-75,Other
7921,Ridgeview,1356,1320,2017-09-05,36,MS
7922,Robertson,431,444,2017-09-05,-13,ES
7923,Round Rock,3372,3374,2017-09-05,-2,HS
7924,Sommer,1227,1223,2017-09-05,4,ES
7925,Spicewood,808,805,2017-09-05,3,ES
7926,Stony Point,2625,2615,2017-09-05,10,HS
7927,Success,309,341,2017-09-05,-32,HS
7928,Teravista,864,845,2017-09-05,19,ES
7929,Union Hill,730,745,2017-09-05,-15,ES
7930,Voigt,529,569,2017-09-05,-40,ES
7931,Walsh,1461,1426,2017-09-05,35,MS
7932,Wells Branch,467,486,2017-09-05,-19,ES
7933,Westwood,2748,2732,2017-09-05,16,HS
7934,LOTT,2,11,2017-09-05,-9,Other
7935,Johnson,729,553,2017-09-12,176,ES
7936,Anderson Mill,522,533,2017-09-12,-11,ES
7937,Berkman,466,475,2017-09-12,-9,ES
7938,Blackland Prairie,798,742,2017-09-12,56,ES
7939,Bluebonnet,361,424,2017-09-12,-63,ES
7940,Brushy Creek,747,786,2017-09-12,-39,ES
7941,C.D. Fulkes,704,682,2017-09-12,22,MS
7942,Cactus Ranch,969,948,2017-09-12,21,ES
7943,Caldwell Heights,716,651,2017-09-12,65,ES
7944,Callison,797,821,2017-09-12,-24,ES
7945,Canyon Creek,427,437,2017-09-12,-10,ES
7946,Canyon Vista,1345,1353,2017-09-12,-8,MS
7947,Caraway,814,769,2017-09-12,45,ES
7948,Cedar Ridge,2768,2712,2017-09-12,56,HS
7949,Cedar Valley,1273,1231,2017-09-12,42,MS
7950,Chandler Oaks,562,556,2017-09-12,6,ES
7951,Chisholm Trail,946,868,2017-09-12,78,MS
7952,DAEP,0,9,2017-09-12,-9,Other
7953,Deepwood,349,334,2017-09-12,15,ES
7954,Deerpark,916,868,2017-09-12,48,MS
7955,Double File Trail,623,659,2017-09-12,-36,ES
7956,Early College,221,219,2017-09-12,2,HS
7957,England,1087,1029,2017-09-12,58,ES
7958,Fern Bluff,607,593,2017-09-12,14,ES
7959,Forest Creek,834,844,2017-09-12,-10,ES
7960,Forest North,346,367,2017-09-12,-21,ES
7961,Gattis,740,714,2017-09-12,26,ES
7962,Great Oaks,712,692,2017-09-12,20,ES
7963,Grisham,649,622,2017-09-12,27,MS
7964,Hernandez,749,778,2017-09-12,-29,MS
7965,Herrington,1027,1100,2017-09-12,-73,ES
7966,Hopewell,1111,1088,2017-09-12,23,MS
7967,JJAEP,6,5,2017-09-12,1,Other
7968,Jollyville,448,439,2017-09-12,9,ES
7969,Laurel Mountain,751,773,2017-09-12,-22,ES
7970,Live Oak,534,582,2017-09-12,-48,ES
7971,McNeil,2705,2726,2017-09-12,-21,HS
7972,Old Town,751,745,2017-09-12,6,ES
7973,Pearson Ranch,660,803,2017-09-12,-143,MS
7974,Pond Springs,634,672,2017-09-12,-38,ES
7975,Purple Sage,440,407,2017-09-12,33,ES
7976,Round Rock Opportunity Center,52,118,2017-09-12,-66,Other
7977,Ridgeview,1354,1320,2017-09-12,34,MS
7978,Robertson,432,444,2017-09-12,-12,ES
7979,Round Rock,3366,3374,2017-09-12,-8,HS
7980,Sommer,1229,1223,2017-09-12,6,ES
7981,Spicewood,811,805,2017-09-12,6,ES
7982,Stony Point,2624,2615,2017-09-12,9,HS
7983,Success,310,341,2017-09-12,-31,HS
7984,Teravista,864,845,2017-09-12,19,ES
7985,Union Hill,726,745,2017-09-12,-19,ES
7986,Voigt,531,569,2017-09-12,-38,ES
7987,Walsh,1463,1426,2017-09-12,37,MS
7988,Wells Branch,468,486,2017-09-12,-18,ES
7989,Westwood,2755,2732,2017-09-12,23,HS
7990,LOTT,3,11,2017-09-12,-8,Other
7991,Johnson,732,553,2017-09-19,179,ES
7992,Anderson Mill,522,533,2017-09-19,-11,ES
7993,Berkman,469,475,2017-09-19,-6,ES
7994,Blackland Prairie,800,742,2017-09-19,58,ES
7995,Bluebonnet,365,424,2017-09-19,-59,ES
7996,Brushy Creek,748,786,2017-09-19,-38,ES
7997,C.D. Fulkes,703,682,2017-09-19,21,MS
7998,Cactus Ranch,970,948,2017-09-19,22,ES
7999,Caldwell Heights,716,651,2017-09-19,65,ES
8000,Callison,801,821,2017-09-19,-20,ES
8001,Canyon Creek,430,437,2017-09-19,-7,ES
8002,Canyon Vista,1344,1353,2017-09-19,-9,MS
8003,Caraway,817,769,2017-09-19,48,ES
8004,Cedar Ridge,2764,2712,2017-09-19,52,HS
8005,Cedar Valley,1274,1231,2017-09-19,43,MS
8006,Chandler Oaks,561,556,2017-09-19,5,ES
8007,Chisholm Trail,950,868,2017-09-19,82,MS
8008,DAEP,2,9,2017-09-19,-7,Other
8009,Deepwood,348,334,2017-09-19,14,ES
8010,Deerpark,912,868,2017-09-19,44,MS
8011,Double File Trail,629,659,2017-09-19,-30,ES
8012,Early College,219,219,2017-09-19,0,HS
8013,England,1091,1029,2017-09-19,62,ES
8014,Fern Bluff,608,593,2017-09-19,15,ES
8015,Forest Creek,833,844,2017-09-19,-11,ES
8016,Forest North,347,367,2017-09-19,-20,ES
8017,Gattis,740,714,2017-09-19,26,ES
8018,Great Oaks,715,692,2017-09-19,23,ES
8019,Grisham,650,622,2017-09-19,28,MS
8020,Hernandez,750,778,2017-09-19,-28,MS
8021,Herrington,1032,1100,2017-09-19,-68,ES
8022,Hopewell,1110,1088,2017-09-19,22,MS
8023,JJAEP,5,5,2017-09-19,0,Other
8024,Jollyville,444,439,2017-09-19,5,ES
8025,Laurel Mountain,752,773,2017-09-19,-21,ES
8026,Live Oak,538,582,2017-09-19,-44,ES
8027,McNeil,2693,2726,2017-09-19,-33,HS
8028,Old Town,752,745,2017-09-19,7,ES
8029,Pearson Ranch,658,803,2017-09-19,-145,MS
8030,Pond Springs,634,672,2017-09-19,-38,ES
8031,Purple Sage,439,407,2017-09-19,32,ES
8032,Round Rock Opportunity Center,55,118,2017-09-19,-63,Other
8033,Ridgeview,1353,1320,2017-09-19,33,MS
8034,Robertson,429,444,2017-09-19,-15,ES
8035,Round Rock,3364,3374,2017-09-19,-10,HS
8036,Sommer,1229,1223,2017-09-19,6,ES
8037,Spicewood,810,805,2017-09-19,5,ES
8038,Stony Point,2620,2615,2017-09-19,5,HS
8039,Success,314,341,2017-09-19,-27,HS
8040,Teravista,866,845,2017-09-19,21,ES
8041,Union Hill,731,745,2017-09-19,-14,ES
8042,Voigt,532,569,2017-09-19,-37,ES
8043,Walsh,1464,1426,2017-09-19,38,MS
8044,Wells Branch,472,486,2017-09-19,-14,ES
8045,Westwood,2752,2732,2017-09-19,20,HS
8046,LOTT,4,11,2017-09-19,-7,Other
8047,Johnson,736,553,2017-09-26,183,ES
8048,Anderson Mill,522,533,2017-09-26,-11,ES
8049,Berkman,471,475,2017-09-26,-4,ES
8050,Blackland Prairie,800,742,2017-09-26,58,ES
8051,Bluebonnet,368,424,2017-09-26,-56,ES
8052,Brushy Creek,747,786,2017-09-26,-39,ES
8053,C.D. Fulkes,704,682,2017-09-26,22,MS
8054,Cactus Ranch,970,948,2017-09-26,22,ES
8055,Caldwell Heights,725,651,2017-09-26,74,ES
8056,Callison,804,821,2017-09-26,-17,ES
8057,Canyon Creek,430,437,2017-09-26,-7,ES
8058,Canyon Vista,1344,1353,2017-09-26,-9,MS
8059,Caraway,818,769,2017-09-26,49,ES
8060,Cedar Ridge,2764,2712,2017-09-26,52,HS
8061,Cedar Valley,1273,1231,2017-09-26,42,MS
8062,Chandler Oaks,561,556,2017-09-26,5,ES
8063,Chisholm Trail,956,868,2017-09-26,88,MS
8064,DAEP,3,9,2017-09-26,-6,Other
8065,Deepwood,350,334,2017-09-26,16,ES
8066,Deerpark,909,868,2017-09-26,41,MS
8067,Double File Trail,627,659,2017-09-26,-32,ES
8068,Early College,219,219,2017-09-26,0,HS
8069,England,1098,1029,2017-09-26,69,ES
8070,Fern Bluff,608,593,2017-09-26,15,ES
8071,Forest Creek,833,844,2017-09-26,-11,ES
8072,Forest North,351,367,2017-09-26,-16,ES
8073,Gattis,740,714,2017-09-26,26,ES
8074,Great Oaks,715,692,2017-09-26,23,ES
8075,Grisham,650,622,2017-09-26,28,MS
8076,Hernandez,751,778,2017-09-26,-27,MS
8077,Herrington,1037,1100,2017-09-26,-63,ES
8078,Hopewell,1108,1088,2017-09-26,20,MS
8079,JJAEP,5,5,2017-09-26,0,Other
8080,Jollyville,445,439,2017-09-26,6,ES
8081,Laurel Mountain,752,773,2017-09-26,-21,ES
8082,Live Oak,539,582,2017-09-26,-43,ES
8083,McNeil,2694,2726,2017-09-26,-32,HS
8084,Old Town,752,745,2017-09-26,7,ES
8085,Pearson Ranch,660,803,2017-09-26,-143,MS
8086,Pond Springs,633,672,2017-09-26,-39,ES
8087,Purple Sage,440,407,2017-09-26,33,ES
8088,Round Rock Opportunity Center,62,118,2017-09-26,-56,Other
8089,Ridgeview,1354,1320,2017-09-26,34,MS
8090,Robertson,431,444,2017-09-26,-13,ES
8091,Round Rock,3359,3374,2017-09-26,-15,HS
8092,Sommer,1229,1223,2017-09-26,6,ES
8093,Spicewood,809,805,2017-09-26,4,ES
8094,Stony Point,2610,2615,2017-09-26,-5,HS
8095,Success,328,341,2017-09-26,-13,HS
8096,Teravista,867,845,2017-09-26,22,ES
8097,Union Hill,730,745,2017-09-26,-15,ES
8098,Voigt,538,569,2017-09-26,-31,ES
8099,Walsh,1464,1426,2017-09-26,38,MS
8100,Wells Branch,472,486,2017-09-26,-14,ES
8101,Westwood,2752,2732,2017-09-26,20,HS
8102,LOTT,2,11,2017-09-26,-9,Other
8103,Johnson,732,553,2017-10-03,179,ES
8104,Anderson Mill,524,533,2017-10-03,-9,ES
8105,Berkman,468,475,2017-10-03,-7,ES
8106,Blackland Prairie,799,742,2017-10-03,57,ES
8107,Bluebonnet,366,424,2017-10-03,-58,ES
8108,Brushy Creek,749,786,2017-10-03,-37,ES
8109,C.D. Fulkes,706,682,2017-10-03,24,MS
8110,Cactus Ranch,971,948,2017-10-03,23,ES
8111,Caldwell Heights,728,651,2017-10-03,77,ES
8112,Callison,804,821,2017-10-03,-17,ES
8113,Canyon Creek,430,437,2017-10-03,-7,ES
8114,Canyon Vista,1345,1353,2017-10-03,-8,MS
8115,Caraway,815,769,2017-10-03,46,ES
8116,Cedar Ridge,2759,2712,2017-10-03,47,HS
8117,Cedar Valley,1275,1231,2017-10-03,44,MS
8118,Chandler Oaks,559,556,2017-10-03,3,ES
8119,Chisholm Trail,955,868,2017-10-03,87,MS
8120,DAEP,4,9,2017-10-03,-5,Other
8121,Deepwood,349,334,2017-10-03,15,ES
8122,Deerpark,904,868,2017-10-03,36,MS
8123,Double File Trail,625,659,2017-10-03,-34,ES
8124,Early College,219,219,2017-10-03,0,HS
8125,England,1095,1029,2017-10-03,66,ES
8126,Fern Bluff,614,593,2017-10-03,21,ES
8127,Forest Creek,832,844,2017-10-03,-12,ES
8128,Forest North,346,367,2017-10-03,-21,ES
8129,Gattis,741,714,2017-10-03,27,ES
8130,Great Oaks,715,692,2017-10-03,23,ES
8131,Grisham,652,622,2017-10-03,30,MS
8132,Hernandez,753,778,2017-10-03,-25,MS
8133,Herrington,1034,1100,2017-10-03,-66,ES
8134,Hopewell,1108,1088,2017-10-03,20,MS
8135,JJAEP,5,5,2017-10-03,0,Other
8136,Jollyville,447,439,2017-10-03,8,ES
8137,Laurel Mountain,755,773,2017-10-03,-18,ES
8138,Live Oak,537,582,2017-10-03,-45,ES
8139,McNeil,2680,2726,2017-10-03,-46,HS
8140,Old Town,750,745,2017-10-03,5,ES
8141,Pearson Ranch,663,803,2017-10-03,-140,MS
8142,Pond Springs,634,672,2017-10-03,-38,ES
8143,Purple Sage,436,407,2017-10-03,29,ES
8144,Round Rock Opportunity Center,67,118,2017-10-03,-51,Other
8145,Ridgeview,1352,1320,2017-10-03,32,MS
8146,Robertson,434,444,2017-10-03,-10,ES
8147,Round Rock,3358,3374,2017-10-03,-16,HS
8148,Sommer,1230,1223,2017-10-03,7,ES
8149,Spicewood,809,805,2017-10-03,4,ES
8150,Stony Point,2606,2615,2017-10-03,-9,HS
8151,Success,329,341,2017-10-03,-12,HS
8152,Teravista,869,845,2017-10-03,24,ES
8153,Union Hill,727,745,2017-10-03,-18,ES
8154,Voigt,542,569,2017-10-03,-27,ES
8155,Walsh,1465,1426,2017-10-03,39,MS
8156,Wells Branch,470,486,2017-10-03,-16,ES
8157,Westwood,2751,2732,2017-10-03,19,HS
8158,LOTT,3,11,2017-10-03,-8,Other
8159,Johnson,730,553,2017-10-10,177,ES
8160,Anderson Mill,522,533,2017-10-10,-11,ES
8161,Berkman,470,475,2017-10-10,-5,ES
8162,Blackland Prairie,800,742,2017-10-10,58,ES
8163,Bluebonnet,366,424,2017-10-10,-58,ES
8164,Brushy Creek,750,786,2017-10-10,-36,ES
8165,C.D. Fulkes,706,682,2017-10-10,24,MS
8166,Cactus Ranch,975,948,2017-10-10,27,ES
8167,Caldwell Heights,728,651,2017-10-10,77,ES
8168,Callison,804,821,2017-10-10,-17,ES
8169,Canyon Creek,430,437,2017-10-10,-7,ES
8170,Canyon Vista,1345,1353,2017-10-10,-8,MS
8171,Caraway,815,769,2017-10-10,46,ES
8172,Cedar Ridge,2765,2712,2017-10-10,53,HS
8173,Cedar Valley,1272,1231,2017-10-10,41,MS
8174,Chandler Oaks,559,556,2017-10-10,3,ES
8175,Chisholm Trail,954,868,2017-10-10,86,MS
8176,DAEP,4,9,2017-10-10,-5,Other
8177,Deepwood,348,334,2017-10-10,14,ES
8178,Deerpark,905,868,2017-10-10,37,MS
8179,Double File Trail,626,659,2017-10-10,-33,ES
8180,Early College,219,219,2017-10-10,0,HS
8181,England,1098,1029,2017-10-10,69,ES
8182,Fern Bluff,614,593,2017-10-10,21,ES
8183,Forest Creek,832,844,2017-10-10,-12,ES
8184,Forest North,348,367,2017-10-10,-19,ES
8185,Gattis,739,714,2017-10-10,25,ES
8186,Great Oaks,718,692,2017-10-10,26,ES
8187,Grisham,654,622,2017-10-10,32,MS
8188,Hernandez,753,778,2017-10-10,-25,MS
8189,Herrington,1034,1100,2017-10-10,-66,ES
8190,Hopewell,1108,1088,2017-10-10,20,MS
8191,JJAEP,5,5,2017-10-10,0,Other
8192,Jollyville,447,439,2017-10-10,8,ES
8193,Laurel Mountain,755,773,2017-10-10,-18,ES
8194,Live Oak,533,582,2017-10-10,-49,ES
8195,McNeil,2675,2726,2017-10-10,-51,HS
8196,Old Town,750,745,2017-10-10,5,ES
8197,Pearson Ranch,663,803,2017-10-10,-140,MS
8198,Pond Springs,634,672,2017-10-10,-38,ES
8199,Purple Sage,439,407,2017-10-10,32,ES
8200,Round Rock Opportunity Center,72,118,2017-10-10,-46,Other
8201,Ridgeview,1352,1320,2017-10-10,32,MS
8202,Robertson,433,444,2017-10-10,-11,ES
8203,Round Rock,3354,3374,2017-10-10,-20,HS
8204,Sommer,1230,1223,2017-10-10,7,ES
8205,Spicewood,809,805,2017-10-10,4,ES
8206,Stony Point,2604,2615,2017-10-10,-11,HS
8207,Success,315,341,2017-10-10,-26,HS
8208,Teravista,864,845,2017-10-10,19,ES
8209,Union Hill,726,745,2017-10-10,-19,ES
8210,Voigt,539,569,2017-10-10,-30,ES
8211,Walsh,1463,1426,2017-10-10,37,MS
8212,Wells Branch,473,486,2017-10-10,-13,ES
8213,Westwood,2747,2732,2017-10-10,15,HS
8214,LOTT,2,11,2017-10-10,-9,Other
8215,Johnson,726,553,2017-10-17,173,ES
8216,Anderson Mill,523,533,2017-10-17,-10,ES
8217,Berkman,474,475,2017-10-17,-1,ES
8218,Blackland Prairie,800,742,2017-10-17,58,ES
8219,Bluebonnet,365,424,2017-10-17,-59,ES
8220,Brushy Creek,756,786,2017-10-17,-30,ES
8221,C.D. Fulkes,713,682,2017-10-17,31,MS
8222,Cactus Ranch,975,948,2017-10-17,27,ES
8223,Caldwell Heights,731,651,2017-10-17,80,ES
8224,Callison,802,821,2017-10-17,-19,ES
8225,Canyon Creek,431,437,2017-10-17,-6,ES
8226,Canyon Vista,1347,1353,2017-10-17,-6,MS
8227,Caraway,816,769,2017-10-17,47,ES
8228,Cedar Ridge,2769,2712,2017-10-17,57,HS
8229,Cedar Valley,1275,1231,2017-10-17,44,MS
8230,Chandler Oaks,561,556,2017-10-17,5,ES
8231,Chisholm Trail,956,868,2017-10-17,88,MS
8232,DAEP,6,9,2017-10-17,-3,Other
8233,Deepwood,352,334,2017-10-17,18,ES
8234,Deerpark,910,868,2017-10-17,42,MS
8235,Double File Trail,624,659,2017-10-17,-35,ES
8236,Early College,220,219,2017-10-17,1,HS
8237,England,1103,1029,2017-10-17,74,ES
8238,Fern Bluff,616,593,2017-10-17,23,ES
8239,Forest Creek,831,844,2017-10-17,-13,ES
8240,Forest North,350,367,2017-10-17,-17,ES
8241,Gattis,738,714,2017-10-17,24,ES
8242,Great Oaks,718,692,2017-10-17,26,ES
8243,Grisham,654,622,2017-10-17,32,MS
8244,Hernandez,754,778,2017-10-17,-24,MS
8245,Herrington,1036,1100,2017-10-17,-64,ES
8246,Hopewell,1110,1088,2017-10-17,22,MS
8247,JJAEP,6,5,2017-10-17,1,Other
8248,Jollyville,452,439,2017-10-17,13,ES
8249,Laurel Mountain,755,773,2017-10-17,-18,ES
8250,Live Oak,532,582,2017-10-17,-50,ES
8251,McNeil,2670,2726,2017-10-17,-56,HS
8252,Old Town,751,745,2017-10-17,6,ES
8253,Pearson Ranch,664,803,2017-10-17,-139,MS
8254,Pond Springs,635,672,2017-10-17,-37,ES
8255,Purple Sage,439,407,2017-10-17,32,ES
8256,Round Rock Opportunity Center,77,118,2017-10-17,-41,Other
8257,Ridgeview,1353,1320,2017-10-17,33,MS
8258,Robertson,433,444,2017-10-17,-11,ES
8259,Round Rock,3360,3374,2017-10-17,-14,HS
8260,Sommer,1232,1223,2017-10-17,9,ES
8261,Spicewood,807,805,2017-10-17,2,ES
8262,Stony Point,2600,2615,2017-10-17,-15,HS
8263,Success,315,341,2017-10-17,-26,HS
8264,Teravista,868,845,2017-10-17,23,ES
8265,Union Hill,724,745,2017-10-17,-21,ES
8266,Voigt,530,569,2017-10-17,-39,ES
8267,Walsh,1461,1426,2017-10-17,35,MS
8268,Wells Branch,474,486,2017-10-17,-12,ES
8269,Westwood,2746,2732,2017-10-17,14,HS
8270,LOTT,1,11,2017-10-17,-10,Other
8271,Johnson,729,553,2017-10-24,176,ES
8272,Anderson Mill,523,533,2017-10-24,-10,ES
8273,Berkman,473,475,2017-10-24,-2,ES
8274,Blackland Prairie,800,742,2017-10-24,58,ES
8275,Bluebonnet,370,424,2017-10-24,-54,ES
8276,Brushy Creek,757,786,2017-10-24,-29,ES
8277,C.D. Fulkes,715,682,2017-10-24,33,MS
8278,Cactus Ranch,975,948,2017-10-24,27,ES
8279,Caldwell Heights,735,651,2017-10-24,84,ES
8280,Callison,809,821,2017-10-24,-12,ES
8281,Canyon Creek,430,437,2017-10-24,-7,ES
8282,Canyon Vista,1348,1353,2017-10-24,-5,MS
8283,Caraway,821,769,2017-10-24,52,ES
8284,Cedar Ridge,2765,2712,2017-10-24,53,HS
8285,Cedar Valley,1275,1231,2017-10-24,44,MS
8286,Chandler Oaks,559,556,2017-10-24,3,ES
8287,Chisholm Trail,952,868,2017-10-24,84,MS
8288,DAEP,7,9,2017-10-24,-2,Other
8289,Deepwood,350,334,2017-10-24,16,ES
8290,Deerpark,904,868,2017-10-24,36,MS
8291,Double File Trail,628,659,2017-10-24,-31,ES
8292,Early College,220,219,2017-10-24,1,HS
8293,England,1103,1029,2017-10-24,74,ES
8294,Fern Bluff,617,593,2017-10-24,24,ES
8295,Forest Creek,830,844,2017-10-24,-14,ES
8296,Forest North,347,367,2017-10-24,-20,ES
8297,Gattis,738,714,2017-10-24,24,ES
8298,Great Oaks,718,692,2017-10-24,26,ES
8299,Grisham,656,622,2017-10-24,34,MS
8300,Hernandez,754,778,2017-10-24,-24,MS
8301,Herrington,1037,1100,2017-10-24,-63,ES
8302,Hopewell,1114,1088,2017-10-24,26,MS
8303,JJAEP,6,5,2017-10-24,1,Other
8304,Jollyville,453,439,2017-10-24,14,ES
8305,Laurel Mountain,757,773,2017-10-24,-16,ES
8306,Live Oak,535,582,2017-10-24,-47,ES
8307,McNeil,2667,2726,2017-10-24,-59,HS
8308,Old Town,750,745,2017-10-24,5,ES
8309,Pearson Ranch,668,803,2017-10-24,-135,MS
8310,Pond Springs,637,672,2017-10-24,-35,ES
8311,Purple Sage,444,407,2017-10-24,37,ES
8312,Round Rock Opportunity Center,78,118,2017-10-24,-40,Other
8313,Ridgeview,1354,1320,2017-10-24,34,MS
8314,Robertson,431,444,2017-10-24,-13,ES
8315,Round Rock,3353,3374,2017-10-24,-21,HS
8316,Sommer,1234,1223,2017-10-24,11,ES
8317,Spicewood,806,805,2017-10-24,1,ES
8318,Stony Point,2606,2615,2017-10-24,-9,HS
8319,Success,307,341,2017-10-24,-34,HS
8320,Teravista,868,845,2017-10-24,23,ES
8321,Union Hill,728,745,2017-10-24,-17,ES
8322,Voigt,529,569,2017-10-24,-40,ES
8323,Walsh,1460,1426,2017-10-24,34,MS
8324,Wells Branch,473,486,2017-10-24,-13,ES
8325,Westwood,2745,2732,2017-10-24,13,HS
8326,LOTT,2,11,2017-10-24,-9,Other
8327,Johnson,729,553,2017-10-31,176,ES
8328,Anderson Mill,521,533,2017-10-31,-12,ES
8329,Berkman,471,475,2017-10-31,-4,ES
8330,Blackland Prairie,800,742,2017-10-31,58,ES
8331,Bluebonnet,370,424,2017-10-31,-54,ES
8332,Brushy Creek,759,786,2017-10-31,-27,ES
8333,C.D. Fulkes,713,682,2017-10-31,31,MS
8334,Cactus Ranch,973,948,2017-10-31,25,ES
8335,Caldwell Heights,735,651,2017-10-31,84,ES
8336,Callison,798,821,2017-10-31,-23,ES
8337,Canyon Creek,428,437,2017-10-31,-9,ES
8338,Canyon Vista,1348,1353,2017-10-31,-5,MS
8339,Caraway,819,769,2017-10-31,50,ES
8340,Cedar Ridge,2763,2712,2017-10-31,51,HS
8341,Cedar Valley,1277,1231,2017-10-31,46,MS
8342,Chandler Oaks,563,556,2017-10-31,7,ES
8343,Chisholm Trail,953,868,2017-10-31,85,MS
8344,DAEP,8,9,2017-10-31,-1,Other
8345,Deepwood,350,334,2017-10-31,16,ES
8346,Deerpark,904,868,2017-10-31,36,MS
8347,Double File Trail,631,659,2017-10-31,-28,ES
8348,Early College,221,219,2017-10-31,2,HS
8349,England,1103,1029,2017-10-31,74,ES
8350,Fern Bluff,617,593,2017-10-31,24,ES
8351,Forest Creek,831,844,2017-10-31,-13,ES
8352,Forest North,346,367,2017-10-31,-21,ES
8353,Gattis,741,714,2017-10-31,27,ES
8354,Great Oaks,718,692,2017-10-31,26,ES
8355,Grisham,657,622,2017-10-31,35,MS
8356,Hernandez,751,778,2017-10-31,-27,MS
8357,Herrington,1039,1100,2017-10-31,-61,ES
8358,Hopewell,1115,1088,2017-10-31,27,MS
8359,JJAEP,6,5,2017-10-31,1,Other
8360,Jollyville,453,439,2017-10-31,14,ES
8361,Laurel Mountain,759,773,2017-10-31,-14,ES
8362,Live Oak,536,582,2017-10-31,-46,ES
8363,McNeil,2662,2726,2017-10-31,-64,HS
8364,Old Town,748,745,2017-10-31,3,ES
8365,Pearson Ranch,666,803,2017-10-31,-137,MS
8366,Pond Springs,637,672,2017-10-31,-35,ES
8367,Purple Sage,437,407,2017-10-31,30,ES
8368,Round Rock Opportunity Center,79,118,2017-10-31,-39,Other
8369,Ridgeview,1353,1320,2017-10-31,33,MS
8370,Robertson,431,444,2017-10-31,-13,ES
8371,Round Rock,3354,3374,2017-10-31,-20,HS
8372,Sommer,1235,1223,2017-10-31,12,ES
8373,Spicewood,807,805,2017-10-31,2,ES
8374,Stony Point,2605,2615,2017-10-31,-10,HS
8375,Success,315,341,2017-10-31,-26,HS
8376,Teravista,870,845,2017-10-31,25,ES
8377,Union Hill,730,745,2017-10-31,-15,ES
8378,Voigt,527,569,2017-10-31,-42,ES
8379,Walsh,1459,1426,2017-10-31,33,MS
8380,Wells Branch,473,486,2017-10-31,-13,ES
8381,Westwood,2742,2732,2017-10-31,10,HS
8382,LOTT,3,11,2017-10-31,-8,Other
8383,Johnson,732,553,2017-11-07,179,ES
8384,Anderson Mill,523,533,2017-11-07,-10,ES
8385,Berkman,473,475,2017-11-07,-2,ES
8386,Blackland Prairie,798,742,2017-11-07,56,ES
8387,Bluebonnet,374,424,2017-11-07,-50,ES
8388,Brushy Creek,760,786,2017-11-07,-26,ES
8389,C.D. Fulkes,711,682,2017-11-07,29,MS
8390,Cactus Ranch,974,948,2017-11-07,26,ES
8391,Caldwell Heights,736,651,2017-11-07,85,ES
8392,Callison,797,821,2017-11-07,-24,ES
8393,Canyon Creek,427,437,2017-11-07,-10,ES
8394,Canyon Vista,1349,1353,2017-11-07,-4,MS
8395,Caraway,814,769,2017-11-07,45,ES
8396,Cedar Ridge,2763,2712,2017-11-07,51,HS
8397,Cedar Valley,1279,1231,2017-11-07,48,MS
8398,Chandler Oaks,566,556,2017-11-07,10,ES
8399,Chisholm Trail,957,868,2017-11-07,89,MS
8400,DAEP,7,9,2017-11-07,-2,Other
8401,Deepwood,351,334,2017-11-07,17,ES
8402,Deerpark,903,868,2017-11-07,35,MS
8403,Double File Trail,630,659,2017-11-07,-29,ES
8404,Early College,221,219,2017-11-07,2,HS
8405,England,1107,1029,2017-11-07,78,ES
8406,Fern Bluff,616,593,2017-11-07,23,ES
8407,Forest Creek,832,844,2017-11-07,-12,ES
8408,Forest North,346,367,2017-11-07,-21,ES
8409,Gattis,739,714,2017-11-07,25,ES
8410,Great Oaks,721,692,2017-11-07,29,ES
8411,Grisham,656,622,2017-11-07,34,MS
8412,Hernandez,749,778,2017-11-07,-29,MS
8413,Herrington,1040,1100,2017-11-07,-60,ES
8414,Hopewell,1115,1088,2017-11-07,27,MS
8415,JJAEP,9,5,2017-11-07,4,Other
8416,Jollyville,458,439,2017-11-07,19,ES
8417,Laurel Mountain,760,773,2017-11-07,-13,ES
8418,Live Oak,538,582,2017-11-07,-44,ES
8419,McNeil,2653,2726,2017-11-07,-73,HS
8420,Old Town,750,745,2017-11-07,5,ES
8421,Pearson Ranch,666,803,2017-11-07,-137,MS
8422,Pond Springs,637,672,2017-11-07,-35,ES
8423,Purple Sage,437,407,2017-11-07,30,ES
8424,Round Rock Opportunity Center,83,118,2017-11-07,-35,Other
8425,Ridgeview,1353,1320,2017-11-07,33,MS
8426,Robertson,434,444,2017-11-07,-10,ES
8427,Round Rock,3345,3374,2017-11-07,-29,HS
8428,Sommer,1235,1223,2017-11-07,12,ES
8429,Spicewood,808,805,2017-11-07,3,ES
8430,Stony Point,2607,2615,2017-11-07,-8,HS
8431,Success,311,341,2017-11-07,-30,HS
8432,Teravista,867,845,2017-11-07,22,ES
8433,Union Hill,728,745,2017-11-07,-17,ES
8434,Voigt,525,569,2017-11-07,-44,ES
8435,Walsh,1458,1426,2017-11-07,32,MS
8436,Wells Branch,472,486,2017-11-07,-14,ES
8437,Westwood,2742,2732,2017-11-07,10,HS
8438,LOTT,4,11,2017-11-07,-7,Other
8439,Johnson,737,553,2017-11-14,184,ES
8440,Anderson Mill,522,533,2017-11-14,-11,ES
8441,Berkman,473,475,2017-11-14,-2,ES
8442,Blackland Prairie,798,742,2017-11-14,56,ES
8443,Bluebonnet,380,424,2017-11-14,-44,ES
8444,Brushy Creek,756,786,2017-11-14,-30,ES
8445,C.D. Fulkes,708,682,2017-11-14,26,MS
8446,Cactus Ranch,976,948,2017-11-14,28,ES
8447,Caldwell Heights,737,651,2017-11-14,86,ES
8448,Callison,794,821,2017-11-14,-27,ES
8449,Canyon Creek,427,437,2017-11-14,-10,ES
8450,Canyon Vista,1349,1353,2017-11-14,-4,MS
8451,Caraway,813,769,2017-11-14,44,ES
8452,Cedar Ridge,2760,2712,2017-11-14,48,HS
8453,Cedar Valley,1279,1231,2017-11-14,48,MS
8454,Chandler Oaks,568,556,2017-11-14,12,ES
8455,Chisholm Trail,958,868,2017-11-14,90,MS
8456,DAEP,8,9,2017-11-14,-1,Other
8457,Deepwood,351,334,2017-11-14,17,ES
8458,Deerpark,901,868,2017-11-14,33,MS
8459,Double File Trail,632,659,2017-11-14,-27,ES
8460,Early College,221,219,2017-11-14,2,HS
8461,England,1107,1029,2017-11-14,78,ES
8462,Fern Bluff,618,593,2017-11-14,25,ES
8463,Forest Creek,833,844,2017-11-14,-11,ES
8464,Forest North,348,367,2017-11-14,-19,ES
8465,Gattis,741,714,2017-11-14,27,ES
8466,Great Oaks,722,692,2017-11-14,30,ES
8467,Grisham,656,622,2017-11-14,34,MS
8468,Hernandez,751,778,2017-11-14,-27,MS
8469,Herrington,1043,1100,2017-11-14,-57,ES
8470,Hopewell,1113,1088,2017-11-14,25,MS
8471,JJAEP,10,5,2017-11-14,5,Other
8472,Jollyville,458,439,2017-11-14,19,ES
8473,Laurel Mountain,760,773,2017-11-14,-13,ES
8474,Live Oak,542,582,2017-11-14,-40,ES
8475,McNeil,2642,2726,2017-11-14,-84,HS
8476,Old Town,752,745,2017-11-14,7,ES
8477,Pearson Ranch,665,803,2017-11-14,-138,MS
8478,Pond Springs,632,672,2017-11-14,-40,ES
8479,Purple Sage,437,407,2017-11-14,30,ES
8480,Round Rock Opportunity Center,88,118,2017-11-14,-30,Other
8481,Ridgeview,1355,1320,2017-11-14,35,MS
8482,Robertson,435,444,2017-11-14,-9,ES
8483,Round Rock,3345,3374,2017-11-14,-29,HS
8484,Sommer,1234,1223,2017-11-14,11,ES
8485,Spicewood,805,805,2017-11-14,0,ES
8486,Stony Point,2604,2615,2017-11-14,-11,HS
8487,Success,317,341,2017-11-14,-24,HS
8488,Teravista,864,845,2017-11-14,19,ES
8489,Union Hill,728,745,2017-11-14,-17,ES
8490,Voigt,525,569,2017-11-14,-44,ES
8491,Walsh,1458,1426,2017-11-14,32,MS
8492,Wells Branch,470,486,2017-11-14,-16,ES
8493,Westwood,2740,2732,2017-11-14,8,HS
8494,LOTT,3,11,2017-11-14,-8,Other
8495,Johnson,728,553,2017-11-28,175,ES
8496,Anderson Mill,524,533,2017-11-28,-9,ES
8497,Berkman,473,475,2017-11-28,-2,ES
8498,Blackland Prairie,795,742,2017-11-28,53,ES
8499,Bluebonnet,379,424,2017-11-28,-45,ES
8500,Brushy Creek,756,786,2017-11-28,-30,ES
8501,C.D. Fulkes,704,682,2017-11-28,22,MS
8502,Cactus Ranch,974,948,2017-11-28,26,ES
8503,Caldwell Heights,741,651,2017-11-28,90,ES
8504,Callison,790,821,2017-11-28,-31,ES
8505,Canyon Creek,427,437,2017-11-28,-10,ES
8506,Canyon Vista,1346,1353,2017-11-28,-7,MS
8507,Caraway,816,769,2017-11-28,47,ES
8508,Cedar Ridge,2764,2712,2017-11-28,52,HS
8509,Cedar Valley,1275,1231,2017-11-28,44,MS
8510,Chandler Oaks,568,556,2017-11-28,12,ES
8511,Chisholm Trail,957,868,2017-11-28,89,MS
8512,DAEP,8,9,2017-11-28,-1,Other
8513,Deepwood,352,334,2017-11-28,18,ES
8514,Deerpark,899,868,2017-11-28,31,MS
8515,Double File Trail,633,659,2017-11-28,-26,ES
8516,Early College,221,219,2017-11-28,2,HS
8517,England,1103,1029,2017-11-28,74,ES
8518,Fern Bluff,615,593,2017-11-28,22,ES
8519,Forest Creek,835,844,2017-11-28,-9,ES
8520,Forest North,351,367,2017-11-28,-16,ES
8521,Gattis,744,714,2017-11-28,30,ES
8522,Great Oaks,724,692,2017-11-28,32,ES
8523,Grisham,658,622,2017-11-28,36,MS
8524,Hernandez,750,778,2017-11-28,-28,MS
8525,Herrington,1042,1100,2017-11-28,-58,ES
8526,Hopewell,1114,1088,2017-11-28,26,MS
8527,JJAEP,11,5,2017-11-28,6,Other
8528,Jollyville,463,439,2017-11-28,24,ES
8529,Laurel Mountain,760,773,2017-11-28,-13,ES
8530,Live Oak,544,582,2017-11-28,-38,ES
8531,McNeil,2634,2726,2017-11-28,-92,HS
8532,Old Town,752,745,2017-11-28,7,ES
8533,Pearson Ranch,663,803,2017-11-28,-140,MS
8534,Pond Springs,636,672,2017-11-28,-36,ES
8535,Purple Sage,439,407,2017-11-28,32,ES
8536,Round Rock Opportunity Center,83,118,2017-11-28,-35,Other
8537,Ridgeview,1358,1320,2017-11-28,38,MS
8538,Robertson,430,444,2017-11-28,-14,ES
8539,Round Rock,3345,3374,2017-11-28,-29,HS
8540,Sommer,1230,1223,2017-11-28,7,ES
8541,Spicewood,806,805,2017-11-28,1,ES
8542,Stony Point,2602,2615,2017-11-28,-13,HS
8543,Success,313,341,2017-11-28,-28,HS
8544,Teravista,864,845,2017-11-28,19,ES
8545,Union Hill,726,745,2017-11-28,-19,ES
8546,Voigt,526,569,2017-11-28,-43,ES
8547,Walsh,1459,1426,2017-11-28,33,MS
8548,Wells Branch,468,486,2017-11-28,-18,ES
8549,Westwood,2738,2732,2017-11-28,6,HS
8550,LOTT,4,11,2017-11-28,-7,Other
8551,Johnson,724,553,2017-12-05,171,ES
8552,Anderson Mill,526,533,2017-12-05,-7,ES
8553,Berkman,472,475,2017-12-05,-3,ES
8554,Blackland Prairie,794,742,2017-12-05,52,ES
8555,Bluebonnet,375,424,2017-12-05,-49,ES
8556,Brushy Creek,757,786,2017-12-05,-29,ES
8557,C.D. Fulkes,702,682,2017-12-05,20,MS
8558,Cactus Ranch,975,948,2017-12-05,27,ES
8559,Caldwell Heights,740,651,2017-12-05,89,ES
8560,Callison,792,821,2017-12-05,-29,ES
8561,Canyon Creek,424,437,2017-12-05,-13,ES
8562,Canyon Vista,1344,1353,2017-12-05,-9,MS
8563,Caraway,813,769,2017-12-05,44,ES
8564,Cedar Ridge,2762,2712,2017-12-05,50,HS
8565,Cedar Valley,1277,1231,2017-12-05,46,MS
8566,Chandler Oaks,567,556,2017-12-05,11,ES
8567,Chisholm Trail,953,868,2017-12-05,85,MS
8568,DAEP,8,9,2017-12-05,-1,Other
8569,Deepwood,356,334,2017-12-05,22,ES
8570,Deerpark,902,868,2017-12-05,34,MS
8571,Double File Trail,632,659,2017-12-05,-27,ES
8572,Early College,221,219,2017-12-05,2,HS
8573,England,1102,1029,2017-12-05,73,ES
8574,Fern Bluff,618,593,2017-12-05,25,ES
8575,Forest Creek,833,844,2017-12-05,-11,ES
8576,Forest North,354,367,2017-12-05,-13,ES
8577,Gattis,745,714,2017-12-05,31,ES
8578,Great Oaks,725,692,2017-12-05,33,ES
8579,Grisham,659,622,2017-12-05,37,MS
8580,Hernandez,750,778,2017-12-05,-28,MS
8581,Herrington,1042,1100,2017-12-05,-58,ES
8582,Hopewell,1112,1088,2017-12-05,24,MS
8583,JJAEP,11,5,2017-12-05,6,Other
8584,Jollyville,466,439,2017-12-05,27,ES
8585,Laurel Mountain,761,773,2017-12-05,-12,ES
8586,Live Oak,545,582,2017-12-05,-37,ES
8587,McNeil,2633,2726,2017-12-05,-93,HS
8588,Old Town,754,745,2017-12-05,9,ES
8589,Pearson Ranch,662,803,2017-12-05,-141,MS
8590,Pond Springs,635,672,2017-12-05,-37,ES
8591,Purple Sage,437,407,2017-12-05,30,ES
8592,Round Rock Opportunity Center,89,118,2017-12-05,-29,Other
8593,Ridgeview,1363,1320,2017-12-05,43,MS
8594,Robertson,428,444,2017-12-05,-16,ES
8595,Round Rock,3340,3374,2017-12-05,-34,HS
8596,Sommer,1227,1223,2017-12-05,4,ES
8597,Spicewood,804,805,2017-12-05,-1,ES
8598,Stony Point,2602,2615,2017-12-05,-13,HS
8599,Success,307,341,2017-12-05,-34,HS
8600,Teravista,868,845,2017-12-05,23,ES
8601,Union Hill,723,745,2017-12-05,-22,ES
8602,Voigt,527,569,2017-12-05,-42,ES
8603,Walsh,1457,1426,2017-12-05,31,MS
8604,Wells Branch,469,486,2017-12-05,-17,ES
8605,Westwood,2737,2732,2017-12-05,5,HS
8606,LOTT,6,11,2017-12-05,-5,Other
8607,Johnson,721,553,2017-12-12,168,ES
8608,Anderson Mill,527,533,2017-12-12,-6,ES
8609,Berkman,468,475,2017-12-12,-7,ES
8610,Blackland Prairie,794,742,2017-12-12,52,ES
8611,Bluebonnet,375,424,2017-12-12,-49,ES
8612,Brushy Creek,759,786,2017-12-12,-27,ES
8613,C.D. Fulkes,704,682,2017-12-12,22,MS
8614,Cactus Ranch,968,948,2017-12-12,20,ES
8615,Caldwell Heights,737,651,2017-12-12,86,ES
8616,Callison,799,821,2017-12-12,-22,ES
8617,Canyon Creek,422,437,2017-12-12,-15,ES
8618,Canyon Vista,1346,1353,2017-12-12,-7,MS
8619,Caraway,812,769,2017-12-12,43,ES
8620,Cedar Ridge,2759,2712,2017-12-12,47,HS
8621,Cedar Valley,1278,1231,2017-12-12,47,MS
8622,Chandler Oaks,567,556,2017-12-12,11,ES
8623,Chisholm Trail,952,868,2017-12-12,84,MS
8624,DAEP,7,9,2017-12-12,-2,Other
8625,Deepwood,356,334,2017-12-12,22,ES
8626,Deerpark,900,868,2017-12-12,32,MS
8627,Double File Trail,632,659,2017-12-12,-27,ES
8628,Early College,221,219,2017-12-12,2,HS
8629,England,1097,1029,2017-12-12,68,ES
8630,Fern Bluff,619,593,2017-12-12,26,ES
8631,Forest Creek,835,844,2017-12-12,-9,ES
8632,Forest North,358,367,2017-12-12,-9,ES
8633,Gattis,745,714,2017-12-12,31,ES
8634,Great Oaks,726,692,2017-12-12,34,ES
8635,Grisham,655,622,2017-12-12,33,MS
8636,Hernandez,748,778,2017-12-12,-30,MS
8637,Herrington,1038,1100,2017-12-12,-62,ES
8638,Hopewell,1106,1088,2017-12-12,18,MS
8639,JJAEP,11,5,2017-12-12,6,Other
8640,Jollyville,468,439,2017-12-12,29,ES
8641,Laurel Mountain,763,773,2017-12-12,-10,ES
8642,Live Oak,545,582,2017-12-12,-37,ES
8643,McNeil,2628,2726,2017-12-12,-98,HS
8644,Old Town,752,745,2017-12-12,7,ES
8645,Pearson Ranch,661,803,2017-12-12,-142,MS
8646,Pond Springs,641,672,2017-12-12,-31,ES
8647,Purple Sage,438,407,2017-12-12,31,ES
8648,Round Rock Opportunity Center,103,118,2017-12-12,-15,Other
8649,Ridgeview,1363,1320,2017-12-12,43,MS
8650,Robertson,428,444,2017-12-12,-16,ES
8651,Round Rock,3335,3374,2017-12-12,-39,HS
8652,Sommer,1227,1223,2017-12-12,4,ES
8653,Spicewood,802,805,2017-12-12,-3,ES
8654,Stony Point,2599,2615,2017-12-12,-16,HS
8655,Success,305,341,2017-12-12,-36,HS
8656,Teravista,869,845,2017-12-12,24,ES
8657,Union Hill,727,745,2017-12-12,-18,ES
8658,Voigt,525,569,2017-12-12,-44,ES
8659,Walsh,1457,1426,2017-12-12,31,MS
8660,Wells Branch,469,486,2017-12-12,-17,ES
8661,Westwood,2735,2732,2017-12-12,3,HS
8662,LOTT,6,11,2017-12-12,-5,Other
8663,Johnson,720,553,2017-12-19,167,ES
8664,Anderson Mill,523,533,2017-12-19,-10,ES
8665,Berkman,469,475,2017-12-19,-6,ES
8666,Blackland Prairie,794,742,2017-12-19,52,ES
8667,Bluebonnet,378,424,2017-12-19,-46,ES
8668,Brushy Creek,758,786,2017-12-19,-28,ES
8669,C.D. Fulkes,702,682,2017-12-19,20,MS
8670,Cactus Ranch,965,948,2017-12-19,17,ES
8671,Caldwell Heights,734,651,2017-12-19,83,ES
8672,Callison,798,821,2017-12-19,-23,ES
8673,Canyon Creek,422,437,2017-12-19,-15,ES
8674,Canyon Vista,1346,1353,2017-12-19,-7,MS
8675,Caraway,810,769,2017-12-19,41,ES
8676,Cedar Ridge,2756,2712,2017-12-19,44,HS
8677,Cedar Valley,1277,1231,2017-12-19,46,MS
8678,Chandler Oaks,567,556,2017-12-19,11,ES
8679,Chisholm Trail,951,868,2017-12-19,83,MS
8680,DAEP,8,9,2017-12-19,-1,Other
8681,Deepwood,357,334,2017-12-19,23,ES
8682,Deerpark,899,868,2017-12-19,31,MS
8683,Double File Trail,633,659,2017-12-19,-26,ES
8684,Early College,221,219,2017-12-19,2,HS
8685,England,1101,1029,2017-12-19,72,ES
8686,Fern Bluff,618,593,2017-12-19,25,ES
8687,Forest Creek,835,844,2017-12-19,-9,ES
8688,Forest North,358,367,2017-12-19,-9,ES
8689,Gattis,748,714,2017-12-19,34,ES
8690,Great Oaks,724,692,2017-12-19,32,ES
8691,Grisham,654,622,2017-12-19,32,MS
8692,Hernandez,745,778,2017-12-19,-33,MS
8693,Herrington,1036,1100,2017-12-19,-64,ES
8694,Hopewell,1104,1088,2017-12-19,16,MS
8695,JJAEP,12,5,2017-12-19,7,Other
8696,Jollyville,468,439,2017-12-19,29,ES
8697,Laurel Mountain,763,773,2017-12-19,-10,ES
8698,Live Oak,548,582,2017-12-19,-34,ES
8699,McNeil,2627,2726,2017-12-19,-99,HS
8700,Old Town,754,745,2017-12-19,9,ES
8701,Pearson Ranch,661,803,2017-12-19,-142,MS
8702,Pond Springs,641,672,2017-12-19,-31,ES
8703,Purple Sage,437,407,2017-12-19,30,ES
8704,Round Rock Opportunity Center,118,118,2017-12-19,0,Other
8705,Ridgeview,1363,1320,2017-12-19,43,MS
8706,Robertson,428,444,2017-12-19,-16,ES
8707,Round Rock,3332,3374,2017-12-19,-42,HS
8708,Sommer,1227,1223,2017-12-19,4,ES
8709,Spicewood,804,805,2017-12-19,-1,ES
8710,Stony Point,2597,2615,2017-12-19,-18,HS
8711,Success,297,341,2017-12-19,-44,HS
8712,Teravista,869,845,2017-12-19,24,ES
8713,Union Hill,729,745,2017-12-19,-16,ES
8714,Voigt,522,569,2017-12-19,-47,ES
8715,Walsh,1456,1426,2017-12-19,30,MS
8716,Wells Branch,469,486,2017-12-19,-17,ES
8717,Westwood,2731,2732,2017-12-19,-1,HS
8718,LOTT,3,11,2017-12-19,-8,Other
8719,Johnson,714,553,2018-01-09,161,ES
8720,Anderson Mill,518,533,2018-01-09,-15,ES
8721,Berkman,473,475,2018-01-09,-2,ES
8722,Blackland Prairie,795,742,2018-01-09,53,ES
8723,Bluebonnet,382,424,2018-01-09,-42,ES
8724,Brushy Creek,765,786,2018-01-09,-21,ES
8725,C.D. Fulkes,702,682,2018-01-09,20,MS
8726,Cactus Ranch,968,948,2018-01-09,20,ES
8727,Caldwell Heights,735,651,2018-01-09,84,ES
8728,Callison,805,821,2018-01-09,-16,ES
8729,Canyon Creek,431,437,2018-01-09,-6,ES
8730,Canyon Vista,1353,1353,2018-01-09,0,MS
8731,Caraway,819,769,2018-01-09,50,ES
8732,Cedar Ridge,2773,2712,2018-01-09,61,HS
8733,Cedar Valley,1280,1231,2018-01-09,49,MS
8734,Chandler Oaks,568,556,2018-01-09,12,ES
8735,Chisholm Trail,949,868,2018-01-09,81,MS
8736,DAEP,6,9,2018-01-09,-3,Other
8737,Deepwood,358,334,2018-01-09,24,ES
8738,Deerpark,903,868,2018-01-09,35,MS
8739,Double File Trail,640,659,2018-01-09,-19,ES
8740,Early College,216,219,2018-01-09,-3,HS
8741,England,1104,1029,2018-01-09,75,ES
8742,Fern Bluff,624,593,2018-01-09,31,ES
8743,Forest Creek,835,844,2018-01-09,-9,ES
8744,Forest North,364,367,2018-01-09,-3,ES
8745,Gattis,757,714,2018-01-09,43,ES
8746,Great Oaks,724,692,2018-01-09,32,ES
8747,Grisham,652,622,2018-01-09,30,MS
8748,Hernandez,745,778,2018-01-09,-33,MS
8749,Herrington,1053,1100,2018-01-09,-47,ES
8750,Hopewell,1114,1088,2018-01-09,26,MS
8751,JJAEP,11,5,2018-01-09,6,Other
8752,Jollyville,468,439,2018-01-09,29,ES
8753,Laurel Mountain,770,773,2018-01-09,-3,ES
8754,Live Oak,554,582,2018-01-09,-28,ES
8755,McNeil,2626,2726,2018-01-09,-100,HS
8756,Old Town,765,745,2018-01-09,20,ES
8757,Pearson Ranch,675,803,2018-01-09,-128,MS
8758,Pond Springs,643,672,2018-01-09,-29,ES
8759,Purple Sage,434,407,2018-01-09,27,ES
8760,Round Rock Opportunity Center,92,118,2018-01-09,-26,Other
8761,Ridgeview,1370,1320,2018-01-09,50,MS
8762,Robertson,430,444,2018-01-09,-14,ES
8763,Round Rock,3331,3374,2018-01-09,-43,HS
8764,Sommer,1232,1223,2018-01-09,9,ES
8765,Spicewood,805,805,2018-01-09,0,ES
8766,Stony Point,2590,2615,2018-01-09,-25,HS
8767,Success,290,341,2018-01-09,-51,HS
8768,Teravista,867,845,2018-01-09,22,ES
8769,Union Hill,726,745,2018-01-09,-19,ES
8770,Voigt,524,569,2018-01-09,-45,ES
8771,Walsh,1450,1426,2018-01-09,24,MS
8772,Wells Branch,465,486,2018-01-09,-21,ES
8773,Westwood,2750,2732,2018-01-09,18,HS
8774,LOTT,5,11,2018-01-09,-6,Other
8775,Johnson,714,553,2018-01-16,161,ES
8776,Anderson Mill,525,533,2018-01-16,-8,ES
8777,Berkman,468,475,2018-01-16,-7,ES
8778,Blackland Prairie,797,742,2018-01-16,55,ES
8779,Bluebonnet,379,424,2018-01-16,-45,ES
8780,Brushy Creek,764,786,2018-01-16,-22,ES
8781,C.D. Fulkes,708,682,2018-01-16,26,MS
8782,Cactus Ranch,970,948,2018-01-16,22,ES
8783,Caldwell Heights,736,651,2018-01-16,85,ES
8784,Callison,810,821,2018-01-16,-11,ES
8785,Canyon Creek,432,437,2018-01-16,-5,ES
8786,Canyon Vista,1353,1353,2018-01-16,0,MS
8787,Caraway,818,769,2018-01-16,49,ES
8788,Cedar Ridge,2757,2712,2018-01-16,45,HS
8789,Cedar Valley,1279,1231,2018-01-16,48,MS
8790,Chandler Oaks,569,556,2018-01-16,13,ES
8791,Chisholm Trail,951,868,2018-01-16,83,MS
8792,DAEP,7,9,2018-01-16,-2,Other
8793,Deepwood,361,334,2018-01-16,27,ES
8794,Deerpark,906,868,2018-01-16,38,MS
8795,Double File Trail,641,659,2018-01-16,-18,ES
8796,Early College,215,219,2018-01-16,-4,HS
8797,England,1108,1029,2018-01-16,79,ES
8798,Fern Bluff,622,593,2018-01-16,29,ES
8799,Forest Creek,837,844,2018-01-16,-7,ES
8800,Forest North,364,367,2018-01-16,-3,ES
8801,Gattis,756,714,2018-01-16,42,ES
8802,Great Oaks,725,692,2018-01-16,33,ES
8803,Grisham,649,622,2018-01-16,27,MS
8804,Hernandez,743,778,2018-01-16,-35,MS
8805,Herrington,1053,1100,2018-01-16,-47,ES
8806,Hopewell,1102,1088,2018-01-16,14,MS
8807,JJAEP,12,5,2018-01-16,7,Other
8808,Jollyville,470,439,2018-01-16,31,ES
8809,Laurel Mountain,770,773,2018-01-16,-3,ES
8810,Live Oak,555,582,2018-01-16,-27,ES
8811,McNeil,2628,2726,2018-01-16,-98,HS
8812,Old Town,763,745,2018-01-16,18,ES
8813,Pearson Ranch,668,803,2018-01-16,-135,MS
8814,Pond Springs,646,672,2018-01-16,-26,ES
8815,Purple Sage,433,407,2018-01-16,26,ES
8816,Round Rock Opportunity Center,100,118,2018-01-16,-18,Other
8817,Ridgeview,1371,1320,2018-01-16,51,MS
8818,Robertson,435,444,2018-01-16,-9,ES
8819,Round Rock,3331,3374,2018-01-16,-43,HS
8820,Sommer,1234,1223,2018-01-16,11,ES
8821,Spicewood,803,805,2018-01-16,-2,ES
8822,Stony Point,2601,2615,2018-01-16,-14,HS
8823,Success,288,341,2018-01-16,-53,HS
8824,Teravista,865,845,2018-01-16,20,ES
8825,Union Hill,729,745,2018-01-16,-16,ES
8826,Voigt,529,569,2018-01-16,-40,ES
8827,Walsh,1447,1426,2018-01-16,21,MS
8828,Wells Branch,469,486,2018-01-16,-17,ES
8829,Westwood,2730,2732,2018-01-16,-2,HS
8830,LOTT,4,11,2018-01-16,-7,Other
8831,Johnson,717,553,2018-01-23,164,ES
8832,Anderson Mill,530,533,2018-01-23,-3,ES
8833,Berkman,463,475,2018-01-23,-12,ES
8834,Blackland Prairie,798,742,2018-01-23,56,ES
8835,Bluebonnet,379,424,2018-01-23,-45,ES
8836,Brushy Creek,759,786,2018-01-23,-27,ES
8837,C.D. Fulkes,711,682,2018-01-23,29,MS
8838,Cactus Ranch,975,948,2018-01-23,27,ES
8839,Caldwell Heights,750,651,2018-01-23,99,ES
8840,Callison,810,821,2018-01-23,-11,ES
8841,Canyon Creek,431,437,2018-01-23,-6,ES
8842,Canyon Vista,1353,1353,2018-01-23,0,MS
8843,Caraway,820,769,2018-01-23,51,ES
8844,Cedar Ridge,2740,2712,2018-01-23,28,HS
8845,Cedar Valley,1281,1231,2018-01-23,50,MS
8846,Chandler Oaks,568,556,2018-01-23,12,ES
8847,Chisholm Trail,950,868,2018-01-23,82,MS
8848,DAEP,8,9,2018-01-23,-1,Other
8849,Deepwood,359,334,2018-01-23,25,ES
8850,Deerpark,905,868,2018-01-23,37,MS
8851,Double File Trail,642,659,2018-01-23,-17,ES
8852,Early College,213,219,2018-01-23,-6,HS
8853,England,1116,1029,2018-01-23,87,ES
8854,Fern Bluff,623,593,2018-01-23,30,ES
8855,Forest Creek,838,844,2018-01-23,-6,ES
8856,Forest North,363,367,2018-01-23,-4,ES
8857,Gattis,756,714,2018-01-23,42,ES
8858,Great Oaks,724,692,2018-01-23,32,ES
8859,Grisham,646,622,2018-01-23,24,MS
8860,Hernandez,741,778,2018-01-23,-37,MS
8861,Herrington,1051,1100,2018-01-23,-49,ES
8862,Hopewell,1106,1088,2018-01-23,18,MS
8863,JJAEP,14,5,2018-01-23,9,Other
8864,Jollyville,474,439,2018-01-23,35,ES
8865,Laurel Mountain,769,773,2018-01-23,-4,ES
8866,Live Oak,558,582,2018-01-23,-24,ES
8867,McNeil,2621,2726,2018-01-23,-105,HS
8868,Old Town,762,745,2018-01-23,17,ES
8869,Pearson Ranch,670,803,2018-01-23,-133,MS
8870,Pond Springs,648,672,2018-01-23,-24,ES
8871,Purple Sage,436,407,2018-01-23,29,ES
8872,Round Rock Opportunity Center,109,118,2018-01-23,-9,Other
8873,Ridgeview,1373,1320,2018-01-23,53,MS
8874,Robertson,433,444,2018-01-23,-11,ES
8875,Round Rock,3333,3374,2018-01-23,-41,HS
8876,Sommer,1239,1223,2018-01-23,16,ES
8877,Spicewood,805,805,2018-01-23,0,ES
8878,Stony Point,2603,2615,2018-01-23,-12,HS
8879,Success,296,341,2018-01-23,-45,HS
8880,Teravista,866,845,2018-01-23,21,ES
8881,Union Hill,731,745,2018-01-23,-14,ES
8882,Voigt,531,569,2018-01-23,-38,ES
8883,Walsh,1448,1426,2018-01-23,22,MS
8884,Wells Branch,471,486,2018-01-23,-15,ES
8885,Westwood,2728,2732,2018-01-23,-4,HS
8886,LOTT,3,11,2018-01-23,-8,Other
8887,Johnson,720,553,2018-01-30,167,ES
8888,Anderson Mill,534,533,2018-01-30,1,ES
8889,Berkman,466,475,2018-01-30,-9,ES
8890,Blackland Prairie,798,742,2018-01-30,56,ES
8891,Bluebonnet,381,424,2018-01-30,-43,ES
8892,Brushy Creek,757,786,2018-01-30,-29,ES
8893,C.D. Fulkes,712,682,2018-01-30,30,MS
8894,Cactus Ranch,977,948,2018-01-30,29,ES
8895,Caldwell Heights,745,651,2018-01-30,94,ES
8896,Callison,814,821,2018-01-30,-7,ES
8897,Canyon Creek,430,437,2018-01-30,-7,ES
8898,Canyon Vista,1354,1353,2018-01-30,1,MS
8899,Caraway,823,769,2018-01-30,54,ES
8900,Cedar Ridge,2732,2712,2018-01-30,20,HS
8901,Cedar Valley,1281,1231,2018-01-30,50,MS
8902,Chandler Oaks,567,556,2018-01-30,11,ES
8903,Chisholm Trail,950,868,2018-01-30,82,MS
8904,DAEP,6,9,2018-01-30,-3,Other
8905,Deepwood,360,334,2018-01-30,26,ES
8906,Deerpark,908,868,2018-01-30,40,MS
8907,Double File Trail,641,659,2018-01-30,-18,ES
8908,Early College,211,219,2018-01-30,-8,HS
8909,England,1121,1029,2018-01-30,92,ES
8910,Fern Bluff,620,593,2018-01-30,27,ES
8911,Forest Creek,837,844,2018-01-30,-7,ES
8912,Forest North,363,367,2018-01-30,-4,ES
8913,Gattis,756,714,2018-01-30,42,ES
8914,Great Oaks,723,692,2018-01-30,31,ES
8915,Grisham,649,622,2018-01-30,27,MS
8916,Hernandez,741,778,2018-01-30,-37,MS
8917,Herrington,1053,1100,2018-01-30,-47,ES
8918,Hopewell,1107,1088,2018-01-30,19,MS
8919,JJAEP,12,5,2018-01-30,7,Other
8920,Jollyville,475,439,2018-01-30,36,ES
8921,Laurel Mountain,769,773,2018-01-30,-4,ES
8922,Live Oak,560,582,2018-01-30,-22,ES
8923,McNeil,2613,2726,2018-01-30,-113,HS
8924,Old Town,766,745,2018-01-30,21,ES
8925,Pearson Ranch,672,803,2018-01-30,-131,MS
8926,Pond Springs,650,672,2018-01-30,-22,ES
8927,Purple Sage,441,407,2018-01-30,34,ES
8928,Round Rock Opportunity Center,106,118,2018-01-30,-12,Other
8929,Ridgeview,1376,1320,2018-01-30,56,MS
8930,Robertson,429,444,2018-01-30,-15,ES
8931,Round Rock,3326,3374,2018-01-30,-48,HS
8932,Sommer,1241,1223,2018-01-30,18,ES
8933,Spicewood,805,805,2018-01-30,0,ES
8934,Stony Point,2601,2615,2018-01-30,-14,HS
8935,Success,296,341,2018-01-30,-45,HS
8936,Teravista,864,845,2018-01-30,19,ES
8937,Union Hill,724,745,2018-01-30,-21,ES
8938,Voigt,533,569,2018-01-30,-36,ES
8939,Walsh,1447,1426,2018-01-30,21,MS
8940,Wells Branch,471,486,2018-01-30,-15,ES
8941,Westwood,2726,2732,2018-01-30,-6,HS
8942,LOTT,3,11,2018-01-30,-8,Other
8943,Johnson,720,553,2018-02-06,167,ES
8944,Anderson Mill,531,533,2018-02-06,-2,ES
8945,Berkman,465,475,2018-02-06,-10,ES
8946,Blackland Prairie,797,742,2018-02-06,55,ES
8947,Bluebonnet,380,424,2018-02-06,-44,ES
8948,Brushy Creek,758,786,2018-02-06,-28,ES
8949,C.D. Fulkes,707,682,2018-02-06,25,MS
8950,Cactus Ranch,976,948,2018-02-06,28,ES
8951,Caldwell Heights,745,651,2018-02-06,94,ES
8952,Callison,813,821,2018-02-06,-8,ES
8953,Canyon Creek,431,437,2018-02-06,-6,ES
8954,Canyon Vista,1357,1353,2018-02-06,4,MS
8955,Caraway,826,769,2018-02-06,57,ES
8956,Cedar Ridge,2727,2712,2018-02-06,15,HS
8957,Cedar Valley,1283,1231,2018-02-06,52,MS
8958,Chandler Oaks,571,556,2018-02-06,15,ES
8959,Chisholm Trail,949,868,2018-02-06,81,MS
8960,DAEP,8,9,2018-02-06,-1,Other
8961,Deepwood,357,334,2018-02-06,23,ES
8962,Deerpark,914,868,2018-02-06,46,MS
8963,Double File Trail,638,659,2018-02-06,-21,ES
8964,Early College,210,219,2018-02-06,-9,HS
8965,England,1121,1029,2018-02-06,92,ES
8966,Fern Bluff,620,593,2018-02-06,27,ES
8967,Forest Creek,837,844,2018-02-06,-7,ES
8968,Forest North,359,367,2018-02-06,-8,ES
8969,Gattis,749,714,2018-02-06,35,ES
8970,Great Oaks,723,692,2018-02-06,31,ES
8971,Grisham,650,622,2018-02-06,28,MS
8972,Hernandez,740,778,2018-02-06,-38,MS
8973,Herrington,1051,1100,2018-02-06,-49,ES
8974,Hopewell,1108,1088,2018-02-06,20,MS
8975,JJAEP,11,5,2018-02-06,6,Other
8976,Jollyville,475,439,2018-02-06,36,ES
8977,Laurel Mountain,769,773,2018-02-06,-4,ES
8978,Live Oak,559,582,2018-02-06,-23,ES
8979,McNeil,2607,2726,2018-02-06,-119,HS
8980,Old Town,763,745,2018-02-06,18,ES
8981,Pearson Ranch,672,803,2018-02-06,-131,MS
8982,Pond Springs,651,672,2018-02-06,-21,ES
8983,Purple Sage,442,407,2018-02-06,35,ES
8984,Round Rock Opportunity Center,103,118,2018-02-06,-15,Other
8985,Ridgeview,1371,1320,2018-02-06,51,MS
8986,Robertson,429,444,2018-02-06,-15,ES
8987,Round Rock,3318,3374,2018-02-06,-56,HS
8988,Sommer,1238,1223,2018-02-06,15,ES
8989,Spicewood,803,805,2018-02-06,-2,ES
8990,Stony Point,2598,2615,2018-02-06,-17,HS
8991,Success,290,341,2018-02-06,-51,HS
8992,Teravista,861,845,2018-02-06,16,ES
8993,Union Hill,722,745,2018-02-06,-23,ES
8994,Voigt,529,569,2018-02-06,-40,ES
8995,Walsh,1446,1426,2018-02-06,20,MS
8996,Wells Branch,476,486,2018-02-06,-10,ES
8997,Westwood,2729,2732,2018-02-06,-3,HS
8998,LOTT,6,11,2018-02-06,-5,Other
8999,Johnson,717,553,2018-02-20,164,ES
9000,Anderson Mill,531,533,2018-02-20,-2,ES
9001,Berkman,464,475,2018-02-20,-11,ES
9002,Blackland Prairie,796,742,2018-02-20,54,ES
9003,Bluebonnet,378,424,2018-02-20,-46,ES
9004,Brushy Creek,757,786,2018-02-20,-29,ES
9005,C.D. Fulkes,705,682,2018-02-20,23,MS
9006,Cactus Ranch,976,948,2018-02-20,28,ES
9007,Caldwell Heights,739,651,2018-02-20,88,ES
9008,Callison,815,821,2018-02-20,-6,ES
9009,Canyon Creek,432,437,2018-02-20,-5,ES
9010,Canyon Vista,1354,1353,2018-02-20,1,MS
9011,Caraway,832,769,2018-02-20,63,ES
9012,Cedar Ridge,2720,2712,2018-02-20,8,HS
9013,Cedar Valley,1286,1231,2018-02-20,55,MS
9014,Chandler Oaks,568,556,2018-02-20,12,ES
9015,Chisholm Trail,948,868,2018-02-20,80,MS
9016,DAEP,6,9,2018-02-20,-3,Other
9017,Deepwood,359,334,2018-02-20,25,ES
9018,Deerpark,915,868,2018-02-20,47,MS
9019,Double File Trail,640,659,2018-02-20,-19,ES
9020,Early College,208,219,2018-02-20,-11,HS
9021,England,1121,1029,2018-02-20,92,ES
9022,Fern Bluff,619,593,2018-02-20,26,ES
9023,Forest Creek,838,844,2018-02-20,-6,ES
9024,Forest North,360,367,2018-02-20,-7,ES
9025,Gattis,748,714,2018-02-20,34,ES
9026,Great Oaks,730,692,2018-02-20,38,ES
9027,Grisham,675,622,2018-02-20,53,MS
9028,Hernandez,651,778,2018-02-20,-127,MS
9029,Herrington,1048,1100,2018-02-20,-52,ES
9030,Hopewell,742,1088,2018-02-20,-346,MS
9031,JJAEP,11,5,2018-02-20,6,Other
9032,Jollyville,476,439,2018-02-20,37,ES
9033,Laurel Mountain,771,773,2018-02-20,-2,ES
9034,Live Oak,562,582,2018-02-20,-20,ES
9035,McNeil,2604,2726,2018-02-20,-122,HS
9036,Old Town,763,745,2018-02-20,18,ES
9037,Pearson Ranch,1369,803,2018-02-20,566,MS
9038,Pond Springs,649,672,2018-02-20,-23,ES
9039,Purple Sage,439,407,2018-02-20,32,ES
9040,Round Rock Opportunity Center,101,118,2018-02-20,-17,Other
9041,Ridgeview,1448,1320,2018-02-20,128,MS
9042,Robertson,431,444,2018-02-20,-13,ES
9043,Round Rock,3316,3374,2018-02-20,-58,HS
9044,Sommer,1239,1223,2018-02-20,16,ES
9045,Spicewood,803,805,2018-02-20,-2,ES
9046,Stony Point,2588,2615,2018-02-20,-27,HS
9047,Success,283,341,2018-02-20,-58,HS
9048,Teravista,860,845,2018-02-20,15,ES
9049,Union Hill,725,745,2018-02-20,-20,ES
9050,Voigt,524,569,2018-02-20,-45,ES
9051,Walsh,1115,1426,2018-02-20,-311,MS
9052,Wells Branch,477,486,2018-02-20,-9,ES
9053,Westwood,2725,2732,2018-02-20,-7,HS
9054,LOTT,1,11,2018-02-20,-10,Other
9055,Johnson,712,553,2018-02-27,159,ES
9056,Anderson Mill,532,533,2018-02-27,-1,ES
9057,Berkman,465,475,2018-02-27,-10,ES
9058,Blackland Prairie,802,742,2018-02-27,60,ES
9059,Bluebonnet,379,424,2018-02-27,-45,ES
9060,Brushy Creek,756,786,2018-02-27,-30,ES
9061,C.D. Fulkes,707,682,2018-02-27,25,MS
9062,Cactus Ranch,977,948,2018-02-27,29,ES
9063,Caldwell Heights,740,651,2018-02-27,89,ES
9064,Callison,818,821,2018-02-27,-3,ES
9065,Canyon Creek,432,437,2018-02-27,-5,ES
9066,Canyon Vista,1354,1353,2018-02-27,1,MS
9067,Caraway,832,769,2018-02-27,63,ES
9068,Cedar Ridge,2721,2712,2018-02-27,9,HS
9069,Cedar Valley,1285,1231,2018-02-27,54,MS
9070,Chandler Oaks,569,556,2018-02-27,13,ES
9071,Chisholm Trail,949,868,2018-02-27,81,MS
9072,DAEP,7,9,2018-02-27,-2,Other
9073,Deepwood,361,334,2018-02-27,27,ES
9074,Deerpark,912,868,2018-02-27,44,MS
9075,Double File Trail,643,659,2018-02-27,-16,ES
9076,Early College,208,219,2018-02-27,-11,HS
9077,England,1121,1029,2018-02-27,92,ES
9078,Fern Bluff,620,593,2018-02-27,27,ES
9079,Forest Creek,838,844,2018-02-27,-6,ES
9080,Forest North,359,367,2018-02-27,-8,ES
9081,Gattis,750,714,2018-02-27,36,ES
9082,Great Oaks,732,692,2018-02-27,40,ES
9083,Grisham,651,622,2018-02-27,29,MS
9084,Hernandez,747,778,2018-02-27,-31,MS
9085,Herrington,1050,1100,2018-02-27,-50,ES
9086,Hopewell,1118,1088,2018-02-27,30,MS
9087,JJAEP,12,5,2018-02-27,7,Other
9088,Jollyville,480,439,2018-02-27,41,ES
9089,Laurel Mountain,769,773,2018-02-27,-4,ES
9090,Live Oak,569,582,2018-02-27,-13,ES
9091,McNeil,2603,2726,2018-02-27,-123,HS
9092,Old Town,767,745,2018-02-27,22,ES
9093,Pearson Ranch,679,803,2018-02-27,-124,MS
9094,Pond Springs,647,672,2018-02-27,-25,ES
9095,Purple Sage,438,407,2018-02-27,31,ES
9096,Round Rock Opportunity Center,101,118,2018-02-27,-17,Other
9097,Ridgeview,1370,1320,2018-02-27,50,MS
9098,Robertson,430,444,2018-02-27,-14,ES
9099,Round Rock,3309,3374,2018-02-27,-65,HS
9100,Sommer,1239,1223,2018-02-27,16,ES
9101,Spicewood,802,805,2018-02-27,-3,ES
9102,Stony Point,2592,2615,2018-02-27,-23,HS
9103,Success,276,341,2018-02-27,-65,HS
9104,Teravista,864,845,2018-02-27,19,ES
9105,Union Hill,721,745,2018-02-27,-24,ES
9106,Voigt,521,569,2018-02-27,-48,ES
9107,Walsh,1450,1426,2018-02-27,24,MS
9108,Wells Branch,477,486,2018-02-27,-9,ES
9109,Westwood,2723,2732,2018-02-27,-9,HS
9110,LOTT,1,11,2018-02-27,-10,Other
9111,Johnson,714,553,2018-03-06,161,ES
9112,Anderson Mill,534,533,2018-03-06,1,ES
9113,Berkman,466,475,2018-03-06,-9,ES
9114,Blackland Prairie,802,742,2018-03-06,60,ES
9115,Bluebonnet,380,424,2018-03-06,-44,ES
9116,Brushy Creek,755,786,2018-03-06,-31,ES
9117,C.D. Fulkes,701,682,2018-03-06,19,MS
9118,Cactus Ranch,977,948,2018-03-06,29,ES
9119,Caldwell Heights,740,651,2018-03-06,89,ES
9120,Callison,819,821,2018-03-06,-2,ES
9121,Canyon Creek,432,437,2018-03-06,-5,ES
9122,Canyon Vista,1355,1353,2018-03-06,2,MS
9123,Caraway,832,769,2018-03-06,63,ES
9124,Cedar Ridge,2717,2712,2018-03-06,5,HS
9125,Cedar Valley,1285,1231,2018-03-06,54,MS
9126,Chandler Oaks,570,556,2018-03-06,14,ES
9127,Chisholm Trail,950,868,2018-03-06,82,MS
9128,DAEP,8,9,2018-03-06,-1,Other
9129,Deepwood,360,334,2018-03-06,26,ES
9130,Deerpark,911,868,2018-03-06,43,MS
9131,Double File Trail,643,659,2018-03-06,-16,ES
9132,Early College,206,219,2018-03-06,-13,HS
9133,England,1126,1029,2018-03-06,97,ES
9134,Fern Bluff,621,593,2018-03-06,28,ES
9135,Forest Creek,837,844,2018-03-06,-7,ES
9136,Forest North,358,367,2018-03-06,-9,ES
9137,Gattis,754,714,2018-03-06,40,ES
9138,Great Oaks,734,692,2018-03-06,42,ES
9139,Grisham,651,622,2018-03-06,29,MS
9140,Hernandez,755,778,2018-03-06,-23,MS
9141,Herrington,1050,1100,2018-03-06,-50,ES
9142,Hopewell,1110,1088,2018-03-06,22,MS
9143,JJAEP,11,5,2018-03-06,6,Other
9144,Jollyville,480,439,2018-03-06,41,ES
9145,Laurel Mountain,771,773,2018-03-06,-2,ES
9146,Live Oak,569,582,2018-03-06,-13,ES
9147,McNeil,2600,2726,2018-03-06,-126,HS
9148,Old Town,769,745,2018-03-06,24,ES
9149,Pearson Ranch,678,803,2018-03-06,-125,MS
9150,Pond Springs,644,672,2018-03-06,-28,ES
9151,Purple Sage,437,407,2018-03-06,30,ES
9152,Round Rock Opportunity Center,103,118,2018-03-06,-15,Other
9153,Ridgeview,1373,1320,2018-03-06,53,MS
9154,Robertson,428,444,2018-03-06,-16,ES
9155,Round Rock,3300,3374,2018-03-06,-74,HS
9156,Sommer,1240,1223,2018-03-06,17,ES
9157,Spicewood,806,805,2018-03-06,1,ES
9158,Stony Point,2595,2615,2018-03-06,-20,HS
9159,Success,279,341,2018-03-06,-62,HS
9160,Teravista,869,845,2018-03-06,24,ES
9161,Union Hill,724,745,2018-03-06,-21,ES
9162,Voigt,518,569,2018-03-06,-51,ES
9163,Walsh,1449,1426,2018-03-06,23,MS
9164,Wells Branch,476,486,2018-03-06,-10,ES
9165,Westwood,2723,2732,2018-03-06,-9,HS
9166,LOTT,1,11,2018-03-06,-10,Other
9167,Johnson,711,553,2018-03-20,158,ES
9168,Anderson Mill,534,533,2018-03-20,1,ES
9169,Berkman,468,475,2018-03-20,-7,ES
9170,Blackland Prairie,806,742,2018-03-20,64,ES
9171,Bluebonnet,383,424,2018-03-20,-41,ES
9172,Brushy Creek,757,786,2018-03-20,-29,ES
9173,C.D. Fulkes,704,682,2018-03-20,22,MS
9174,Cactus Ranch,981,948,2018-03-20,33,ES
9175,Caldwell Heights,746,651,2018-03-20,95,ES
9176,Callison,819,821,2018-03-20,-2,ES
9177,Canyon Creek,432,437,2018-03-20,-5,ES
9178,Canyon Vista,1353,1353,2018-03-20,0,MS
9179,Caraway,831,769,2018-03-20,62,ES
9180,Cedar Ridge,2716,2712,2018-03-20,4,HS
9181,Cedar Valley,1284,1231,2018-03-20,53,MS
9182,Chandler Oaks,572,556,2018-03-20,16,ES
9183,Chisholm Trail,950,868,2018-03-20,82,MS
9184,DAEP,6,9,2018-03-20,-3,Other
9185,Deepwood,360,334,2018-03-20,26,ES
9186,Deerpark,908,868,2018-03-20,40,MS
9187,Double File Trail,643,659,2018-03-20,-16,ES
9188,Early College,205,219,2018-03-20,-14,HS
9189,England,1128,1029,2018-03-20,99,ES
9190,Fern Bluff,622,593,2018-03-20,29,ES
9191,Forest Creek,836,844,2018-03-20,-8,ES
9192,Forest North,358,367,2018-03-20,-9,ES
9193,Gattis,754,714,2018-03-20,40,ES
9194,Great Oaks,735,692,2018-03-20,43,ES
9195,Grisham,652,622,2018-03-20,30,MS
9196,Hernandez,757,778,2018-03-20,-21,MS
9197,Herrington,1051,1100,2018-03-20,-49,ES
9198,Hopewell,1107,1088,2018-03-20,19,MS
9199,JJAEP,9,5,2018-03-20,4,Other
9200,Jollyville,476,439,2018-03-20,37,ES
9201,Laurel Mountain,772,773,2018-03-20,-1,ES
9202,Live Oak,570,582,2018-03-20,-12,ES
9203,McNeil,2597,2726,2018-03-20,-129,HS
9204,Old Town,769,745,2018-03-20,24,ES
9205,Pearson Ranch,681,803,2018-03-20,-122,MS
9206,Pond Springs,648,672,2018-03-20,-24,ES
9207,Purple Sage,439,407,2018-03-20,32,ES
9208,Round Rock Opportunity Center,98,118,2018-03-20,-20,Other
9209,Ridgeview,1372,1320,2018-03-20,52,MS
9210,Robertson,427,444,2018-03-20,-17,ES
9211,Round Rock,3295,3374,2018-03-20,-79,HS
9212,Sommer,1243,1223,2018-03-20,20,ES
9213,Spicewood,807,805,2018-03-20,2,ES
9214,Stony Point,2594,2615,2018-03-20,-21,HS
9215,Success,269,341,2018-03-20,-72,HS
9216,Teravista,871,845,2018-03-20,26,ES
9217,Union Hill,723,745,2018-03-20,-22,ES
9218,Voigt,521,569,2018-03-20,-48,ES
9219,Walsh,1448,1426,2018-03-20,22,MS
9220,Wells Branch,482,486,2018-03-20,-4,ES
9221,Westwood,2721,2732,2018-03-20,-11,HS
9222,LOTT,2,11,2018-03-20,-9,Other
9223,Johnson,716,553,2018-03-27,163,ES
9224,Anderson Mill,536,533,2018-03-27,3,ES
9225,Berkman,470,475,2018-03-27,-5,ES
9226,Blackland Prairie,806,742,2018-03-27,64,ES
9227,Bluebonnet,387,424,2018-03-27,-37,ES
9228,Brushy Creek,761,786,2018-03-27,-25,ES
9229,C.D. Fulkes,702,682,2018-03-27,20,MS
9230,Cactus Ranch,982,948,2018-03-27,34,ES
9231,Caldwell Heights,749,651,2018-03-27,98,ES
9232,Callison,823,821,2018-03-27,2,ES
9233,Canyon Creek,432,437,2018-03-27,-5,ES
9234,Canyon Vista,1356,1353,2018-03-27,3,MS
9235,Caraway,833,769,2018-03-27,64,ES
9236,Cedar Ridge,2709,2712,2018-03-27,-3,HS
9237,Cedar Valley,1287,1231,2018-03-27,56,MS
9238,Chandler Oaks,572,556,2018-03-27,16,ES
9239,Chisholm Trail,950,868,2018-03-27,82,MS
9240,DAEP,6,9,2018-03-27,-3,Other
9241,Deepwood,360,334,2018-03-27,26,ES
9242,Deerpark,903,868,2018-03-27,35,MS
9243,Double File Trail,639,659,2018-03-27,-20,ES
9244,Early College,205,219,2018-03-27,-14,HS
9245,England,1131,1029,2018-03-27,102,ES
9246,Fern Bluff,622,593,2018-03-27,29,ES
9247,Forest Creek,837,844,2018-03-27,-7,ES
9248,Forest North,360,367,2018-03-27,-7,ES
9249,Gattis,758,714,2018-03-27,44,ES
9250,Great Oaks,731,692,2018-03-27,39,ES
9251,Grisham,654,622,2018-03-27,32,MS
9252,Hernandez,755,778,2018-03-27,-23,MS
9253,Herrington,1050,1100,2018-03-27,-50,ES
9254,Hopewell,1106,1088,2018-03-27,18,MS
9255,JJAEP,10,5,2018-03-27,5,Other
9256,Jollyville,480,439,2018-03-27,41,ES
9257,Laurel Mountain,774,773,2018-03-27,1,ES
9258,Live Oak,569,582,2018-03-27,-13,ES
9259,McNeil,2603,2726,2018-03-27,-123,HS
9260,Old Town,770,745,2018-03-27,25,ES
9261,Pearson Ranch,684,803,2018-03-27,-119,MS
9262,Pond Springs,649,672,2018-03-27,-23,ES
9263,Purple Sage,439,407,2018-03-27,32,ES
9264,Round Rock Opportunity Center,99,118,2018-03-27,-19,Other
9265,Ridgeview,1372,1320,2018-03-27,52,MS
9266,Robertson,426,444,2018-03-27,-18,ES
9267,Round Rock,3290,3374,2018-03-27,-84,HS
9268,Sommer,1243,1223,2018-03-27,20,ES
9269,Spicewood,808,805,2018-03-27,3,ES
9270,Stony Point,2586,2615,2018-03-27,-29,HS
9271,Success,257,341,2018-03-27,-84,HS
9272,Teravista,870,845,2018-03-27,25,ES
9273,Union Hill,721,745,2018-03-27,-24,ES
9274,Voigt,517,569,2018-03-27,-52,ES
9275,Walsh,1449,1426,2018-03-27,23,MS
9276,Wells Branch,485,486,2018-03-27,-1,ES
9277,Westwood,2717,2732,2018-03-27,-15,HS
9278,LOTT,2,11,2018-03-27,-9,Other
9279,Johnson,711,553,2018-04-03,158,ES
9280,Anderson Mill,538,533,2018-04-03,5,ES
9281,Berkman,466,475,2018-04-03,-9,ES
9282,Blackland Prairie,807,742,2018-04-03,65,ES
9283,Bluebonnet,389,424,2018-04-03,-35,ES
9284,Brushy Creek,761,786,2018-04-03,-25,ES
9285,C.D. Fulkes,704,682,2018-04-03,22,MS
9286,Cactus Ranch,982,948,2018-04-03,34,ES
9287,Caldwell Heights,747,651,2018-04-03,96,ES
9288,Callison,824,821,2018-04-03,3,ES
9289,Canyon Creek,433,437,2018-04-03,-4,ES
9290,Canyon Vista,1359,1353,2018-04-03,6,MS
9291,Caraway,832,769,2018-04-03,63,ES
9292,Cedar Ridge,2710,2712,2018-04-03,-2,HS
9293,Cedar Valley,1290,1231,2018-04-03,59,MS
9294,Chandler Oaks,570,556,2018-04-03,14,ES
9295,Chisholm Trail,949,868,2018-04-03,81,MS
9296,DAEP,5,9,2018-04-03,-4,Other
9297,Deepwood,360,334,2018-04-03,26,ES
9298,Deerpark,905,868,2018-04-03,37,MS
9299,Double File Trail,638,659,2018-04-03,-21,ES
9300,Early College,205,219,2018-04-03,-14,HS
9301,England,1131,1029,2018-04-03,102,ES
9302,Fern Bluff,622,593,2018-04-03,29,ES
9303,Forest Creek,837,844,2018-04-03,-7,ES
9304,Forest North,366,367,2018-04-03,-1,ES
9305,Gattis,760,714,2018-04-03,46,ES
9306,Great Oaks,728,692,2018-04-03,36,ES
9307,Grisham,653,622,2018-04-03,31,MS
9308,Hernandez,754,778,2018-04-03,-24,MS
9309,Herrington,1054,1100,2018-04-03,-46,ES
9310,Hopewell,1107,1088,2018-04-03,19,MS
9311,JJAEP,9,5,2018-04-03,4,Other
9312,Jollyville,481,439,2018-04-03,42,ES
9313,Laurel Mountain,775,773,2018-04-03,2,ES
9314,Live Oak,572,582,2018-04-03,-10,ES
9315,McNeil,2601,2726,2018-04-03,-125,HS
9316,Old Town,769,745,2018-04-03,24,ES
9317,Pearson Ranch,683,803,2018-04-03,-120,MS
9318,Pond Springs,652,672,2018-04-03,-20,ES
9319,Purple Sage,441,407,2018-04-03,34,ES
9320,Round Rock Opportunity Center,95,118,2018-04-03,-23,Other
9321,Ridgeview,1373,1320,2018-04-03,53,MS
9322,Robertson,425,444,2018-04-03,-19,ES
9323,Round Rock,3288,3374,2018-04-03,-86,HS
9324,Sommer,1239,1223,2018-04-03,16,ES
9325,Spicewood,808,805,2018-04-03,3,ES
9326,Stony Point,2585,2615,2018-04-03,-30,HS
9327,Success,262,341,2018-04-03,-79,HS
9328,Teravista,868,845,2018-04-03,23,ES
9329,Union Hill,722,745,2018-04-03,-23,ES
9330,Voigt,513,569,2018-04-03,-56,ES
9331,Walsh,1449,1426,2018-04-03,23,MS
9332,Wells Branch,486,486,2018-04-03,0,ES
9333,Westwood,2717,2732,2018-04-03,-15,HS
9334,LOTT,3,11,2018-04-03,-8,Other
9335,Johnson,711,553,2018-04-10,158,ES
9336,Anderson Mill,538,533,2018-04-10,5,ES
9337,Berkman,468,475,2018-04-10,-7,ES
9338,Blackland Prairie,807,742,2018-04-10,65,ES
9339,Bluebonnet,392,424,2018-04-10,-32,ES
9340,Brushy Creek,764,786,2018-04-10,-22,ES
9341,C.D. Fulkes,709,682,2018-04-10,27,MS
9342,Cactus Ranch,982,948,2018-04-10,34,ES
9343,Caldwell Heights,747,651,2018-04-10,96,ES
9344,Callison,824,821,2018-04-10,3,ES
9345,Canyon Creek,433,437,2018-04-10,-4,ES
9346,Canyon Vista,1361,1353,2018-04-10,8,MS
9347,Caraway,833,769,2018-04-10,64,ES
9348,Cedar Ridge,2708,2712,2018-04-10,-4,HS
9349,Cedar Valley,1291,1231,2018-04-10,60,MS
9350,Chandler Oaks,570,556,2018-04-10,14,ES
9351,Chisholm Trail,950,868,2018-04-10,82,MS
9352,DAEP,4,9,2018-04-10,-5,Other
9353,Deepwood,360,334,2018-04-10,26,ES
9354,Deerpark,905,868,2018-04-10,37,MS
9355,Double File Trail,639,659,2018-04-10,-20,ES
9356,Early College,205,219,2018-04-10,-14,HS
9357,England,1133,1029,2018-04-10,104,ES
9358,Fern Bluff,622,593,2018-04-10,29,ES
9359,Forest Creek,840,844,2018-04-10,-4,ES
9360,Forest North,366,367,2018-04-10,-1,ES
9361,Gattis,759,714,2018-04-10,45,ES
9362,Great Oaks,728,692,2018-04-10,36,ES
9363,Grisham,653,622,2018-04-10,31,MS
9364,Hernandez,755,778,2018-04-10,-23,MS
9365,Herrington,1054,1100,2018-04-10,-46,ES
9366,Hopewell,1110,1088,2018-04-10,22,MS
9367,JJAEP,6,5,2018-04-10,1,Other
9368,Jollyville,485,439,2018-04-10,46,ES
9369,Laurel Mountain,775,773,2018-04-10,2,ES
9370,Live Oak,573,582,2018-04-10,-9,ES
9371,McNeil,2603,2726,2018-04-10,-123,HS
9372,Old Town,769,745,2018-04-10,24,ES
9373,Pearson Ranch,681,803,2018-04-10,-122,MS
9374,Pond Springs,651,672,2018-04-10,-21,ES
9375,Purple Sage,445,407,2018-04-10,38,ES
9376,Round Rock Opportunity Center,93,118,2018-04-10,-25,Other
9377,Ridgeview,1374,1320,2018-04-10,54,MS
9378,Robertson,421,444,2018-04-10,-23,ES
9379,Round Rock,3284,3374,2018-04-10,-90,HS
9380,Sommer,1240,1223,2018-04-10,17,ES
9381,Spicewood,810,805,2018-04-10,5,ES
9382,Stony Point,2584,2615,2018-04-10,-31,HS
9383,Success,252,341,2018-04-10,-89,HS
9384,Teravista,867,845,2018-04-10,22,ES
9385,Union Hill,726,745,2018-04-10,-19,ES
9386,Voigt,515,569,2018-04-10,-54,ES
9387,Walsh,1449,1426,2018-04-10,23,MS
9388,Wells Branch,486,486,2018-04-10,0,ES
9389,Westwood,2714,2732,2018-04-10,-18,HS
9390,LOTT,2,11,2018-04-10,-9,Other
9391,Johnson,709,553,2018-04-17,156,ES
9392,Anderson Mill,536,533,2018-04-17,3,ES
9393,Berkman,469,475,2018-04-17,-6,ES
9394,Blackland Prairie,807,742,2018-04-17,65,ES
9395,Bluebonnet,393,424,2018-04-17,-31,ES
9396,Brushy Creek,762,786,2018-04-17,-24,ES
9397,C.D. Fulkes,708,682,2018-04-17,26,MS
9398,Cactus Ranch,982,948,2018-04-17,34,ES
9399,Caldwell Heights,744,651,2018-04-17,93,ES
9400,Callison,826,821,2018-04-17,5,ES
9401,Canyon Creek,433,437,2018-04-17,-4,ES
9402,Canyon Vista,1362,1353,2018-04-17,9,MS
9403,Caraway,834,769,2018-04-17,65,ES
9404,Cedar Ridge,2705,2712,2018-04-17,-7,HS
9405,Cedar Valley,1291,1231,2018-04-17,60,MS
9406,Chandler Oaks,570,556,2018-04-17,14,ES
9407,Chisholm Trail,949,868,2018-04-17,81,MS
9408,DAEP,6,9,2018-04-17,-3,Other
9409,Deepwood,361,334,2018-04-17,27,ES
9410,Deerpark,908,868,2018-04-17,40,MS
9411,Double File Trail,636,659,2018-04-17,-23,ES
9412,Early College,205,219,2018-04-17,-14,HS
9413,England,1133,1029,2018-04-17,104,ES
9414,Fern Bluff,621,593,2018-04-17,28,ES
9415,Forest Creek,842,844,2018-04-17,-2,ES
9416,Forest North,366,367,2018-04-17,-1,ES
9417,Gattis,759,714,2018-04-17,45,ES
9418,Great Oaks,729,692,2018-04-17,37,ES
9419,Grisham,656,622,2018-04-17,34,MS
9420,Hernandez,753,778,2018-04-17,-25,MS
9421,Herrington,1058,1100,2018-04-17,-42,ES
9422,Hopewell,1113,1088,2018-04-17,25,MS
9423,JJAEP,5,5,2018-04-17,0,Other
9424,Jollyville,484,439,2018-04-17,45,ES
9425,Laurel Mountain,774,773,2018-04-17,1,ES
9426,Live Oak,573,582,2018-04-17,-9,ES
9427,McNeil,2603,2726,2018-04-17,-123,HS
9428,Old Town,771,745,2018-04-17,26,ES
9429,Pearson Ranch,681,803,2018-04-17,-122,MS
9430,Pond Springs,651,672,2018-04-17,-21,ES
9431,Purple Sage,450,407,2018-04-17,43,ES
9432,Round Rock Opportunity Center,95,118,2018-04-17,-23,Other
9433,Ridgeview,1373,1320,2018-04-17,53,MS
9434,Robertson,420,444,2018-04-17,-24,ES
9435,Round Rock,3277,3374,2018-04-17,-97,HS
9436,Sommer,1241,1223,2018-04-17,18,ES
9437,Spicewood,811,805,2018-04-17,6,ES
9438,Stony Point,2576,2615,2018-04-17,-39,HS
9439,Success,254,341,2018-04-17,-87,HS
9440,Teravista,866,845,2018-04-17,21,ES
9441,Union Hill,728,745,2018-04-17,-17,ES
9442,Voigt,513,569,2018-04-17,-56,ES
9443,Walsh,1447,1426,2018-04-17,21,MS
9444,Wells Branch,485,486,2018-04-17,-1,ES
9445,Westwood,2703,2732,2018-04-17,-29,HS
9446,LOTT,3,11,2018-04-17,-8,Other
9447,Johnson,708,553,2018-04-24,155,ES
9448,Anderson Mill,538,533,2018-04-24,5,ES
9449,Berkman,469,475,2018-04-24,-6,ES
9450,Blackland Prairie,807,742,2018-04-24,65,ES
9451,Bluebonnet,395,424,2018-04-24,-29,ES
9452,Brushy Creek,763,786,2018-04-24,-23,ES
9453,C.D. Fulkes,705,682,2018-04-24,23,MS
9454,Cactus Ranch,982,948,2018-04-24,34,ES
9455,Caldwell Heights,745,651,2018-04-24,94,ES
9456,Callison,829,821,2018-04-24,8,ES
9457,Canyon Creek,433,437,2018-04-24,-4,ES
9458,Canyon Vista,1361,1353,2018-04-24,8,MS
9459,Caraway,834,769,2018-04-24,65,ES
9460,Cedar Ridge,2687,2712,2018-04-24,-25,HS
9461,Cedar Valley,1292,1231,2018-04-24,61,MS
9462,Chandler Oaks,570,556,2018-04-24,14,ES
9463,Chisholm Trail,950,868,2018-04-24,82,MS
9464,DAEP,12,9,2018-04-24,3,Other
9465,Deepwood,359,334,2018-04-24,25,ES
9466,Deerpark,907,868,2018-04-24,39,MS
9467,Double File Trail,638,659,2018-04-24,-21,ES
9468,Early College,205,219,2018-04-24,-14,HS
9469,England,1131,1029,2018-04-24,102,ES
9470,Fern Bluff,622,593,2018-04-24,29,ES
9471,Forest Creek,842,844,2018-04-24,-2,ES
9472,Forest North,365,367,2018-04-24,-2,ES
9473,Gattis,755,714,2018-04-24,41,ES
9474,Great Oaks,730,692,2018-04-24,38,ES
9475,Grisham,657,622,2018-04-24,35,MS
9476,Hernandez,758,778,2018-04-24,-20,MS
9477,Herrington,1060,1100,2018-04-24,-40,ES
9478,Hopewell,1114,1088,2018-04-24,26,MS
9479,JJAEP,7,5,2018-04-24,2,Other
9480,Jollyville,486,439,2018-04-24,47,ES
9481,Laurel Mountain,774,773,2018-04-24,1,ES
9482,Live Oak,572,582,2018-04-24,-10,ES
9483,McNeil,2598,2726,2018-04-24,-128,HS
9484,Old Town,771,745,2018-04-24,26,ES
9485,Pearson Ranch,682,803,2018-04-24,-121,MS
9486,Pond Springs,651,672,2018-04-24,-21,ES
9487,Purple Sage,446,407,2018-04-24,39,ES
9488,Round Rock Opportunity Center,110,118,2018-04-24,-8,Other
9489,Ridgeview,1374,1320,2018-04-24,54,MS
9490,Robertson,420,444,2018-04-24,-24,ES
9491,Round Rock,3276,3374,2018-04-24,-98,HS
9492,Sommer,1241,1223,2018-04-24,18,ES
9493,Spicewood,811,805,2018-04-24,6,ES
9494,Stony Point,2572,2615,2018-04-24,-43,HS
9495,Success,237,341,2018-04-24,-104,HS
9496,Teravista,867,845,2018-04-24,22,ES
9497,Union Hill,729,745,2018-04-24,-16,ES
9498,Voigt,517,569,2018-04-24,-52,ES
9499,Walsh,1446,1426,2018-04-24,20,MS
9500,Wells Branch,491,486,2018-04-24,5,ES
9501,Westwood,2701,2732,2018-04-24,-31,HS
9502,LOTT,1,11,2018-04-24,-10,Other
9503,Johnson,705,553,2018-05-01,152,ES
9504,Anderson Mill,542,533,2018-05-01,9,ES
9505,Berkman,469,475,2018-05-01,-6,ES
9506,Blackland Prairie,809,742,2018-05-01,67,ES
9507,Bluebonnet,396,424,2018-05-01,-28,ES
9508,Brushy Creek,764,786,2018-05-01,-22,ES
9509,C.D. Fulkes,705,682,2018-05-01,23,MS
9510,Cactus Ranch,982,948,2018-05-01,34,ES
9511,Caldwell Heights,743,651,2018-05-01,92,ES
9512,Callison,825,821,2018-05-01,4,ES
9513,Canyon Creek,433,437,2018-05-01,-4,ES
9514,Canyon Vista,1365,1353,2018-05-01,12,MS
9515,Caraway,837,769,2018-05-01,68,ES
9516,Cedar Ridge,2684,2712,2018-05-01,-28,HS
9517,Cedar Valley,1290,1231,2018-05-01,59,MS
9518,Chandler Oaks,574,556,2018-05-01,18,ES
9519,Chisholm Trail,952,868,2018-05-01,84,MS
9520,DAEP,12,9,2018-05-01,3,Other
9521,Deepwood,359,334,2018-05-01,25,ES
9522,Deerpark,907,868,2018-05-01,39,MS
9523,Double File Trail,639,659,2018-05-01,-20,ES
9524,Early College,205,219,2018-05-01,-14,HS
9525,England,1129,1029,2018-05-01,100,ES
9526,Fern Bluff,623,593,2018-05-01,30,ES
9527,Forest Creek,842,844,2018-05-01,-2,ES
9528,Forest North,365,367,2018-05-01,-2,ES
9529,Gattis,756,714,2018-05-01,42,ES
9530,Great Oaks,731,692,2018-05-01,39,ES
9531,Grisham,655,622,2018-05-01,33,MS
9532,Hernandez,760,778,2018-05-01,-18,MS
9533,Herrington,1063,1100,2018-05-01,-37,ES
9534,Hopewell,1114,1088,2018-05-01,26,MS
9535,JJAEP,5,5,2018-05-01,0,Other
9536,Jollyville,486,439,2018-05-01,47,ES
9537,Laurel Mountain,773,773,2018-05-01,0,ES
9538,Live Oak,571,582,2018-05-01,-11,ES
9539,McNeil,2590,2726,2018-05-01,-136,HS
9540,Old Town,773,745,2018-05-01,28,ES
9541,Pearson Ranch,682,803,2018-05-01,-121,MS
9542,Pond Springs,652,672,2018-05-01,-20,ES
9543,Purple Sage,447,407,2018-05-01,40,ES
9544,Round Rock Opportunity Center,121,118,2018-05-01,3,Other
9545,Ridgeview,1372,1320,2018-05-01,52,MS
9546,Robertson,423,444,2018-05-01,-21,ES
9547,Round Rock,3278,3374,2018-05-01,-96,HS
9548,Sommer,1241,1223,2018-05-01,18,ES
9549,Spicewood,811,805,2018-05-01,6,ES
9550,Stony Point,2562,2615,2018-05-01,-53,HS
9551,Success,226,341,2018-05-01,-115,HS
9552,Teravista,870,845,2018-05-01,25,ES
9553,Union Hill,729,745,2018-05-01,-16,ES
9554,Voigt,520,569,2018-05-01,-49,ES
9555,Walsh,1444,1426,2018-05-01,18,MS
9556,Wells Branch,494,486,2018-05-01,8,ES
9557,Westwood,2695,2732,2018-05-01,-37,HS
9558,LOTT,6,11,2018-05-01,-5,Other
9559,Johnson,704,553,2018-05-08,151,ES
9560,Anderson Mill,546,533,2018-05-08,13,ES
9561,Berkman,469,475,2018-05-08,-6,ES
9562,Blackland Prairie,809,742,2018-05-08,67,ES
9563,Bluebonnet,396,424,2018-05-08,-28,ES
9564,Brushy Creek,766,786,2018-05-08,-20,ES
9565,C.D. Fulkes,705,682,2018-05-08,23,MS
9566,Cactus Ranch,982,948,2018-05-08,34,ES
9567,Caldwell Heights,745,651,2018-05-08,94,ES
9568,Callison,827,821,2018-05-08,6,ES
9569,Canyon Creek,432,437,2018-05-08,-5,ES
9570,Canyon Vista,1365,1353,2018-05-08,12,MS
9571,Caraway,839,769,2018-05-08,70,ES
9572,Cedar Ridge,2677,2712,2018-05-08,-35,HS
9573,Cedar Valley,1288,1231,2018-05-08,57,MS
9574,Chandler Oaks,576,556,2018-05-08,20,ES
9575,Chisholm Trail,951,868,2018-05-08,83,MS
9576,DAEP,14,9,2018-05-08,5,Other
9577,Deepwood,359,334,2018-05-08,25,ES
9578,Deerpark,902,868,2018-05-08,34,MS
9579,Double File Trail,639,659,2018-05-08,-20,ES
9580,Early College,205,219,2018-05-08,-14,HS
9581,England,1130,1029,2018-05-08,101,ES
9582,Fern Bluff,623,593,2018-05-08,30,ES
9583,Forest Creek,843,844,2018-05-08,-1,ES
9584,Forest North,366,367,2018-05-08,-1,ES
9585,Gattis,759,714,2018-05-08,45,ES
9586,Great Oaks,733,692,2018-05-08,41,ES
9587,Grisham,653,622,2018-05-08,31,MS
9588,Hernandez,762,778,2018-05-08,-16,MS
9589,Herrington,1063,1100,2018-05-08,-37,ES
9590,Hopewell,1116,1088,2018-05-08,28,MS
9591,JJAEP,5,5,2018-05-08,0,Other
9592,Jollyville,485,439,2018-05-08,46,ES
9593,Laurel Mountain,773,773,2018-05-08,0,ES
9594,Live Oak,573,582,2018-05-08,-9,ES
9595,McNeil,2586,2726,2018-05-08,-140,HS
9596,Old Town,772,745,2018-05-08,27,ES
9597,Pearson Ranch,683,803,2018-05-08,-120,MS
9598,Pond Springs,653,672,2018-05-08,-19,ES
9599,Purple Sage,445,407,2018-05-08,38,ES
9600,Round Rock Opportunity Center,128,118,2018-05-08,10,Other
9601,Ridgeview,1370,1320,2018-05-08,50,MS
9602,Robertson,420,444,2018-05-08,-24,ES
9603,Round Rock,3280,3374,2018-05-08,-94,HS
9604,Sommer,1241,1223,2018-05-08,18,ES
9605,Spicewood,810,805,2018-05-08,5,ES
9606,Stony Point,2562,2615,2018-05-08,-53,HS
9607,Success,211,341,2018-05-08,-130,HS
9608,Teravista,870,845,2018-05-08,25,ES
9609,Union Hill,730,745,2018-05-08,-15,ES
9610,Voigt,519,569,2018-05-08,-50,ES
9611,Walsh,1443,1426,2018-05-08,17,MS
9612,Wells Branch,494,486,2018-05-08,8,ES
9613,Westwood,2696,2732,2018-05-08,-36,HS
9614,LOTT,6,11,2018-05-08,-5,Other
9615,Johnson,701,553,2018-05-15,148,ES
9616,Anderson Mill,544,533,2018-05-15,11,ES
9617,Berkman,470,475,2018-05-15,-5,ES
9618,Blackland Prairie,810,742,2018-05-15,68,ES
9619,Bluebonnet,396,424,2018-05-15,-28,ES
9620,Brushy Creek,767,786,2018-05-15,-19,ES
9621,C.D. Fulkes,704,682,2018-05-15,22,MS
9622,Cactus Ranch,981,948,2018-05-15,33,ES
9623,Caldwell Heights,746,651,2018-05-15,95,ES
9624,Callison,828,821,2018-05-15,7,ES
9625,Canyon Creek,432,437,2018-05-15,-5,ES
9626,Canyon Vista,1364,1353,2018-05-15,11,MS
9627,Caraway,839,769,2018-05-15,70,ES
9628,Cedar Ridge,2674,2712,2018-05-15,-38,HS
9629,Cedar Valley,1288,1231,2018-05-15,57,MS
9630,Chandler Oaks,576,556,2018-05-15,20,ES
9631,Chisholm Trail,950,868,2018-05-15,82,MS
9632,DAEP,14,9,2018-05-15,5,Other
9633,Deepwood,359,334,2018-05-15,25,ES
9634,Deerpark,900,868,2018-05-15,32,MS
9635,Double File Trail,638,659,2018-05-15,-21,ES
9636,Early College,203,219,2018-05-15,-16,HS
9637,England,1131,1029,2018-05-15,102,ES
9638,Fern Bluff,623,593,2018-05-15,30,ES
9639,Forest Creek,842,844,2018-05-15,-2,ES
9640,Forest North,366,367,2018-05-15,-1,ES
9641,Gattis,759,714,2018-05-15,45,ES
9642,Great Oaks,732,692,2018-05-15,40,ES
9643,Grisham,652,622,2018-05-15,30,MS
9644,Hernandez,761,778,2018-05-15,-17,MS
9645,Herrington,1064,1100,2018-05-15,-36,ES
9646,Hopewell,1116,1088,2018-05-15,28,MS
9647,JJAEP,5,5,2018-05-15,0,Other
9648,Jollyville,488,439,2018-05-15,49,ES
9649,Laurel Mountain,773,773,2018-05-15,0,ES
9650,Live Oak,574,582,2018-05-15,-8,ES
9651,McNeil,2581,2726,2018-05-15,-145,HS
9652,Old Town,774,745,2018-05-15,29,ES
9653,Pearson Ranch,682,803,2018-05-15,-121,MS
9654,Pond Springs,654,672,2018-05-15,-18,ES
9655,Purple Sage,443,407,2018-05-15,36,ES
9656,Round Rock Opportunity Center,139,118,2018-05-15,21,Other
9657,Ridgeview,1370,1320,2018-05-15,50,MS
9658,Robertson,420,444,2018-05-15,-24,ES
9659,Round Rock,3277,3374,2018-05-15,-97,HS
9660,Sommer,1243,1223,2018-05-15,20,ES
9661,Spicewood,810,805,2018-05-15,5,ES
9662,Stony Point,2555,2615,2018-05-15,-60,HS
9663,Success,193,341,2018-05-15,-148,HS
9664,Teravista,871,845,2018-05-15,26,ES
9665,Union Hill,733,745,2018-05-15,-12,ES
9666,Voigt,519,569,2018-05-15,-50,ES
9667,Walsh,1443,1426,2018-05-15,17,MS
9668,Wells Branch,495,486,2018-05-15,9,ES
9669,Westwood,2695,2732,2018-05-15,-37,HS
9670,LOTT,4,11,2018-05-15,-7,Other
9671,Johnson,701,553,2018-05-22,148,ES
9672,Anderson Mill,545,533,2018-05-22,12,ES
9673,Berkman,468,475,2018-05-22,-7,ES
9674,Blackland Prairie,809,742,2018-05-22,67,ES
9675,Bluebonnet,397,424,2018-05-22,-27,ES
9676,Brushy Creek,767,786,2018-05-22,-19,ES
9677,C.D. Fulkes,703,682,2018-05-22,21,MS
9678,Cactus Ranch,981,948,2018-05-22,33,ES
9679,Caldwell Heights,747,651,2018-05-22,96,ES
9680,Callison,828,821,2018-05-22,7,ES
9681,Canyon Creek,432,437,2018-05-22,-5,ES
9682,Canyon Vista,1364,1353,2018-05-22,11,MS
9683,Caraway,836,769,2018-05-22,67,ES
9684,Cedar Ridge,2674,2712,2018-05-22,-38,HS
9685,Cedar Valley,1287,1231,2018-05-22,56,MS
9686,Chandler Oaks,575,556,2018-05-22,19,ES
9687,Chisholm Trail,950,868,2018-05-22,82,MS
9688,DAEP,10,9,2018-05-22,1,Other
9689,Deepwood,359,334,2018-05-22,25,ES
9690,Deerpark,899,868,2018-05-22,31,MS
9691,Double File Trail,638,659,2018-05-22,-21,ES
9692,Early College,203,219,2018-05-22,-16,HS
9693,England,1133,1029,2018-05-22,104,ES
9694,Fern Bluff,623,593,2018-05-22,30,ES
9695,Forest Creek,842,844,2018-05-22,-2,ES
9696,Forest North,366,367,2018-05-22,-1,ES
9697,Gattis,759,714,2018-05-22,45,ES
9698,Great Oaks,734,692,2018-05-22,42,ES
9699,Grisham,655,622,2018-05-22,33,MS
9700,Hernandez,761,778,2018-05-22,-17,MS
9701,Herrington,1062,1100,2018-05-22,-38,ES
9702,Hopewell,1116,1088,2018-05-22,28,MS
9703,JJAEP,7,5,2018-05-22,2,Other
9704,Jollyville,490,439,2018-05-22,51,ES
9705,Laurel Mountain,773,773,2018-05-22,0,ES
9706,Live Oak,574,582,2018-05-22,-8,ES
9707,McNeil,2580,2726,2018-05-22,-146,HS
9708,Old Town,775,745,2018-05-22,30,ES
9709,Pearson Ranch,683,803,2018-05-22,-120,MS
9710,Pond Springs,654,672,2018-05-22,-18,ES
9711,Purple Sage,444,407,2018-05-22,37,ES
9712,Round Rock Opportunity Center,141,118,2018-05-22,23,Other
9713,Ridgeview,1370,1320,2018-05-22,50,MS
9714,Robertson,421,444,2018-05-22,-23,ES
9715,Round Rock,3276,3374,2018-05-22,-98,HS
9716,Sommer,1241,1223,2018-05-22,18,ES
9717,Spicewood,812,805,2018-05-22,7,ES
9718,Stony Point,2552,2615,2018-05-22,-63,HS
9719,Success,170,341,2018-05-22,-171,HS
9720,Teravista,870,845,2018-05-22,25,ES
9721,Union Hill,732,745,2018-05-22,-13,ES
9722,Voigt,519,569,2018-05-22,-50,ES
9723,Walsh,1443,1426,2018-05-22,17,MS
9724,Wells Branch,495,486,2018-05-22,9,ES
9725,Westwood,2696,2732,2018-05-22,-36,HS
9726,LOTT,5,11,2018-05-22,-6,Other
9727,Johnson,699,553,2018-05-29,146,ES
9728,Anderson Mill,545,533,2018-05-29,12,ES
9729,Berkman,470,475,2018-05-29,-5,ES
9730,Blackland Prairie,809,742,2018-05-29,67,ES
9731,Bluebonnet,397,424,2018-05-29,-27,ES
9732,Brushy Creek,767,786,2018-05-29,-19,ES
9733,C.D. Fulkes,702,682,2018-05-29,20,MS
9734,Cactus Ranch,981,948,2018-05-29,33,ES
9735,Caldwell Heights,747,651,2018-05-29,96,ES
9736,Callison,827,821,2018-05-29,6,ES
9737,Canyon Creek,432,437,2018-05-29,-5,ES
9738,Canyon Vista,1364,1353,2018-05-29,11,MS
9739,Caraway,837,769,2018-05-29,68,ES
9740,Cedar Ridge,2676,2712,2018-05-29,-36,HS
9741,Cedar Valley,1286,1231,2018-05-29,55,MS
9742,Chandler Oaks,575,556,2018-05-29,19,ES
9743,Chisholm Trail,950,868,2018-05-29,82,MS
9744,DAEP,9,9,2018-05-29,0,Other
9745,Deepwood,359,334,2018-05-29,25,ES
9746,Deerpark,898,868,2018-05-29,30,MS
9747,Double File Trail,638,659,2018-05-29,-21,ES
9748,Early College,203,219,2018-05-29,-16,HS
9749,England,1132,1029,2018-05-29,103,ES
9750,Fern Bluff,623,593,2018-05-29,30,ES
9751,Forest Creek,842,844,2018-05-29,-2,ES
9752,Forest North,363,367,2018-05-29,-4,ES
9753,Gattis,757,714,2018-05-29,43,ES
9754,Great Oaks,734,692,2018-05-29,42,ES
9755,Grisham,655,622,2018-05-29,33,MS
9756,Hernandez,763,778,2018-05-29,-15,MS
9757,Herrington,1061,1100,2018-05-29,-39,ES
9758,Hopewell,1117,1088,2018-05-29,29,MS
9759,JJAEP,6,5,2018-05-29,1,Other
9760,Jollyville,489,439,2018-05-29,50,ES
9761,Laurel Mountain,773,773,2018-05-29,0,ES
9762,Live Oak,571,582,2018-05-29,-11,ES
9763,McNeil,2576,2726,2018-05-29,-150,HS
9764,Old Town,774,745,2018-05-29,29,ES
9765,Pearson Ranch,683,803,2018-05-29,-120,MS
9766,Pond Springs,654,672,2018-05-29,-18,ES
9767,Purple Sage,444,407,2018-05-29,37,ES
9768,Round Rock Opportunity Center,140,118,2018-05-29,22,Other
9769,Ridgeview,1370,1320,2018-05-29,50,MS
9770,Robertson,420,444,2018-05-29,-24,ES
9771,Round Rock,3277,3374,2018-05-29,-97,HS
9772,Sommer,1242,1223,2018-05-29,19,ES
9773,Spicewood,812,805,2018-05-29,7,ES
9774,Stony Point,2554,2615,2018-05-29,-61,HS
9775,Success,150,341,2018-05-29,-191,HS
9776,Teravista,870,845,2018-05-29,25,ES
9777,Union Hill,732,745,2018-05-29,-13,ES
9778,Voigt,518,569,2018-05-29,-51,ES
9779,Walsh,1443,1426,2018-05-29,17,MS
9780,Wells Branch,495,486,2018-05-29,9,ES
9781,Westwood,2696,2732,2018-05-29,-36,HS
9782,LOTT,4,11,2018-05-29,-7,Other
9783,Anderson Mill,572,545,2018-08-28,27,ES
9784,Blackland Prairie,826,785,2018-08-28,41,ES
9785,Bluebonnet,401,360,2018-08-28,41,ES
9786,Brushy Creek,706,729,2018-08-28,-23,ES
9787,C.D. Fulkes,762,738,2018-08-28,24,MS
9788,Cactus Ranch,962,954,2018-08-28,8,ES
9789,Caldwell Heights,795,751,2018-08-28,44,ES
9790,Canyon Creek,437,425,2018-08-28,12,ES
9791,Canyon Vista,1392,1379,2018-08-28,13,MS
9792,Cedar Ridge,2776,2769,2018-08-28,7,HS
9793,Cedar Valley,1295,1279,2018-08-28,16,MS
9794,Chandler Oaks,562,562,2018-08-28,0,ES
9795,Chisholm Trail,944,891,2018-08-28,53,MS
9796,Berkman,450,474,2018-08-28,-24,ES
9797,Deepwood,381,322,2018-08-28,59,ES
9798,Deerpark,936,924,2018-08-28,12,MS
9799,Double File Trail,632,642,2018-08-28,-10,ES
9800,England,1200,1174,2018-08-28,26,ES
9801,Fern Bluff,609,594,2018-08-28,15,ES
9802,Forest Creek,837,809,2018-08-28,28,ES
9803,Forest North,388,360,2018-08-28,28,ES
9804,Gattis,727,735,2018-08-28,-8,ES
9805,Great Oaks,753,705,2018-08-28,48,ES
9806,Hernandez,750,783,2018-08-28,-33,MS
9807,Hopewell,1205,1156,2018-08-28,49,MS
9808,JJAEP,10,6,2018-08-28,4,Other
9809,Walsh,1349,1389,2018-08-28,-40,MS
9810,Johnson,800,807,2018-08-28,-7,ES
9811,Jollyville,446,440,2018-08-28,6,ES
9812,Caraway,856,814,2018-08-28,42,ES
9813,Laurel Mountain,724,732,2018-08-28,-8,ES
9814,Herrington,1098,1116,2018-08-28,-18,ES
9815,Live Oak,599,571,2018-08-28,28,ES
9816,McNeil,2687,2758,2018-08-28,-71,HS
9817,Callison,776,810,2018-08-28,-34,ES
9818,Grisham,627,621,2018-08-28,6,MS
9819,Old Town,717,715,2018-08-28,2,ES
9820,Sommer,1255,1289,2018-08-28,-34,ES
9821,Pearson Ranch,872,820,2018-08-28,52,MS
9822,Pond Springs,588,626,2018-08-28,-38,ES
9823,Purple Sage,478,471,2018-08-28,7,ES
9824,Early College,291,331,2018-08-28,-40,HS
9825,Ridgeview,1364,1333,2018-08-28,31,MS
9826,Robertson,448,414,2018-08-28,34,ES
9827,Round Rock,3534,3515,2018-08-28,19,HS
9828,Round Rock Opportunity Center,52,79,2018-08-28,-27,Other
9829,Spicewood,844,812,2018-08-28,32,ES
9830,Stony Point,2596,2635,2018-08-28,-39,HS
9831,Success,292,315,2018-08-28,-23,HS
9832,Teravista,871,841,2018-08-28,30,ES
9833,Union Hill,772,723,2018-08-28,49,ES
9834,Wells Branch,482,486,2018-08-28,-4,ES
9835,Westwood,2763,2770,2018-08-28,-7,HS
9836,LOTT,3,3,2018-08-28,0,Other
9837,Voigt,570,498,2018-08-28,72,ES
9838,Anderson Mill,579,545,2018-09-04,34,ES
9839,Blackland Prairie,828,785,2018-09-04,43,ES
9840,Bluebonnet,404,360,2018-09-04,44,ES
9841,Brushy Creek,705,729,2018-09-04,-24,ES
9842,C.D. Fulkes,761,738,2018-09-04,23,MS
9843,Cactus Ranch,966,954,2018-09-04,12,ES
9844,Caldwell Heights,798,751,2018-09-04,47,ES
9845,Canyon Creek,438,425,2018-09-04,13,ES
9846,Canyon Vista,1396,1379,2018-09-04,17,MS
9847,Cedar Ridge,2771,2769,2018-09-04,2,HS
9848,Cedar Valley,1291,1279,2018-09-04,12,MS
9849,Chandler Oaks,563,562,2018-09-04,1,ES
9850,Chisholm Trail,944,891,2018-09-04,53,MS
9851,Berkman,458,474,2018-09-04,-16,ES
9852,Deepwood,382,322,2018-09-04,60,ES
9853,Deerpark,932,924,2018-09-04,8,MS
9854,Double File Trail,633,642,2018-09-04,-9,ES
9855,England,1206,1174,2018-09-04,32,ES
9856,Fern Bluff,610,594,2018-09-04,16,ES
9857,Forest Creek,839,809,2018-09-04,30,ES
9858,Forest North,392,360,2018-09-04,32,ES
9859,Gattis,729,735,2018-09-04,-6,ES
9860,Great Oaks,754,705,2018-09-04,49,ES
9861,Hernandez,753,783,2018-09-04,-30,MS
9862,Hopewell,1203,1156,2018-09-04,47,MS
9863,JJAEP,10,6,2018-09-04,4,Other
9864,Walsh,1347,1389,2018-09-04,-42,MS
9865,Johnson,805,807,2018-09-04,-2,ES
9866,Jollyville,444,440,2018-09-04,4,ES
9867,Caraway,864,814,2018-09-04,50,ES
9868,Laurel Mountain,726,732,2018-09-04,-6,ES
9869,Herrington,1103,1116,2018-09-04,-13,ES
9870,Live Oak,605,571,2018-09-04,34,ES
9871,McNeil,2682,2758,2018-09-04,-76,HS
9872,Callison,778,810,2018-09-04,-32,ES
9873,Grisham,627,621,2018-09-04,6,MS
9874,Old Town,716,715,2018-09-04,1,ES
9875,Sommer,1257,1289,2018-09-04,-32,ES
9876,Pearson Ranch,878,820,2018-09-04,58,MS
9877,Pond Springs,588,626,2018-09-04,-38,ES
9878,Purple Sage,485,471,2018-09-04,14,ES
9879,Early College,290,331,2018-09-04,-41,HS
9880,Ridgeview,1367,1333,2018-09-04,34,MS
9881,Robertson,446,414,2018-09-04,32,ES
9882,Round Rock,3522,3515,2018-09-04,7,HS
9883,Round Rock Opportunity Center,56,79,2018-09-04,-23,Other
9884,Spicewood,845,812,2018-09-04,33,ES
9885,Stony Point,2591,2635,2018-09-04,-44,HS
9886,Success,307,315,2018-09-04,-8,HS
9887,Teravista,875,841,2018-09-04,34,ES
9888,Union Hill,772,723,2018-09-04,49,ES
9889,Wells Branch,480,486,2018-09-04,-6,ES
9890,Westwood,2766,2770,2018-09-04,-4,HS
9891,LOTT,3,3,2018-09-04,0,Other
9892,Voigt,565,498,2018-09-04,67,ES
9893,Anderson Mill,583,545,2018-09-11,38,ES
9894,Blackland Prairie,829,785,2018-09-11,44,ES
9895,Bluebonnet,406,360,2018-09-11,46,ES
9896,Brushy Creek,705,729,2018-09-11,-24,ES
9897,C.D. Fulkes,763,738,2018-09-11,25,MS
9898,Cactus Ranch,965,954,2018-09-11,11,ES
9899,Caldwell Heights,793,751,2018-09-11,42,ES
9900,Canyon Creek,438,425,2018-09-11,13,ES
9901,Canyon Vista,1400,1379,2018-09-11,21,MS
9902,Cedar Ridge,2768,2769,2018-09-11,-1,HS
9903,Cedar Valley,1291,1279,2018-09-11,12,MS
9904,Chandler Oaks,565,562,2018-09-11,3,ES
9905,Chisholm Trail,943,891,2018-09-11,52,MS
9906,Berkman,468,474,2018-09-11,-6,ES
9907,DAEP,1,1,2018-09-11,0,Other
9908,Deepwood,382,322,2018-09-11,60,ES
9909,Deerpark,934,924,2018-09-11,10,MS
9910,Double File Trail,636,642,2018-09-11,-6,ES
9911,England,1211,1174,2018-09-11,37,ES
9912,Fern Bluff,610,594,2018-09-11,16,ES
9913,Forest Creek,841,809,2018-09-11,32,ES
9914,Forest North,395,360,2018-09-11,35,ES
9915,Gattis,733,735,2018-09-11,-2,ES
9916,Great Oaks,755,705,2018-09-11,50,ES
9917,Hernandez,754,783,2018-09-11,-29,MS
9918,Hopewell,1206,1156,2018-09-11,50,MS
9919,JJAEP,10,6,2018-09-11,4,Other
9920,Walsh,1347,1389,2018-09-11,-42,MS
9921,Johnson,809,807,2018-09-11,2,ES
9922,Jollyville,446,440,2018-09-11,6,ES
9923,Caraway,872,814,2018-09-11,58,ES
9924,Laurel Mountain,726,732,2018-09-11,-6,ES
9925,Herrington,1109,1116,2018-09-11,-7,ES
9926,Live Oak,604,571,2018-09-11,33,ES
9927,LOTT,3,3,2018-09-11,0,Other
9928,McNeil,2685,2758,2018-09-11,-73,HS
9929,Callison,781,810,2018-09-11,-29,ES
9930,Grisham,631,621,2018-09-11,10,MS
9931,Old Town,711,715,2018-09-11,-4,ES
9932,Sommer,1262,1289,2018-09-11,-27,ES
9933,Pearson Ranch,878,820,2018-09-11,58,MS
9934,Pond Springs,590,626,2018-09-11,-36,ES
9935,Purple Sage,493,471,2018-09-11,22,ES
9936,Early College,289,331,2018-09-11,-42,HS
9937,Round Rock Opportunity Center,55,79,2018-09-11,-24,Other
9938,Ridgeview,1371,1333,2018-09-11,38,MS
9939,Robertson,449,414,2018-09-11,35,ES
9940,Round Rock,3521,3515,2018-09-11,6,HS
9941,Spicewood,844,812,2018-09-11,32,ES
9942,Stony Point,2603,2635,2018-09-11,-32,HS
9943,Success,311,315,2018-09-11,-4,HS
9944,Teravista,872,841,2018-09-11,31,ES
9945,Union Hill,774,723,2018-09-11,51,ES
9946,Wells Branch,482,486,2018-09-11,-4,ES
9947,Westwood,2763,2770,2018-09-11,-7,HS
9948,Voigt,567,498,2018-09-11,69,ES
9949,Anderson Mill,581,545,2018-09-18,36,ES
9950,Blackland Prairie,829,785,2018-09-18,44,ES
9951,Bluebonnet,406,360,2018-09-18,46,ES
9952,Brushy Creek,708,729,2018-09-18,-21,ES
9953,C.D. Fulkes,766,738,2018-09-18,28,MS
9954,Cactus Ranch,965,954,2018-09-18,11,ES
9955,Caldwell Heights,790,751,2018-09-18,39,ES
9956,Canyon Creek,438,425,2018-09-18,13,ES
9957,Canyon Vista,1403,1379,2018-09-18,24,MS
9958,Cedar Ridge,2764,2769,2018-09-18,-5,HS
9959,Cedar Valley,1291,1279,2018-09-18,12,MS
9960,Chandler Oaks,565,562,2018-09-18,3,ES
9961,Chisholm Trail,946,891,2018-09-18,55,MS
9962,Berkman,476,474,2018-09-18,2,ES
9963,Deepwood,389,322,2018-09-18,67,ES
9964,Deerpark,930,924,2018-09-18,6,MS
9965,Double File Trail,639,642,2018-09-18,-3,ES
9966,Early College,289,331,2018-09-18,-42,HS
9967,DAEP,3,0,2018-09-18,3,Other
9968,England,1211,1174,2018-09-18,37,ES
9969,Fern Bluff,609,594,2018-09-18,15,ES
9970,Forest Creek,839,809,2018-09-18,30,ES
9971,Forest North,400,360,2018-09-18,40,ES
9972,Gattis,735,735,2018-09-18,0,ES
9973,Great Oaks,757,705,2018-09-18,52,ES
9974,Hernandez,754,783,2018-09-18,-29,MS
9975,Hopewell,1207,1156,2018-09-18,51,MS
9976,JJAEP,10,0,2018-09-18,10,Other
9977,Walsh,1347,1389,2018-09-18,-42,MS
9978,Johnson,801,807,2018-09-18,-6,ES
9979,Jollyville,451,440,2018-09-18,11,ES
9980,Caraway,875,814,2018-09-18,61,ES
9981,Laurel Mountain,727,732,2018-09-18,-5,ES
9982,Herrington,1113,1116,2018-09-18,-3,ES
9983,Live Oak,602,571,2018-09-18,31,ES
9984,McNeil,2671,2758,2018-09-18,-87,HS
9985,Callison,785,810,2018-09-18,-25,ES
9986,Grisham,633,621,2018-09-18,12,MS
9987,Old Town,707,715,2018-09-18,-8,ES
9988,Sommer,1261,1289,2018-09-18,-28,ES
9989,Pearson Ranch,879,820,2018-09-18,59,MS
9990,Pond Springs,587,626,2018-09-18,-39,ES
9991,Purple Sage,493,471,2018-09-18,22,ES
9992,Round Rock Opportunity Center,57,79,2018-09-18,-22,Other
9993,Ridgeview,1371,1333,2018-09-18,38,MS
9994,Robertson,444,414,2018-09-18,30,ES
9995,Round Rock,3518,3515,2018-09-18,3,HS
9996,Spicewood,846,812,2018-09-18,34,ES
9997,Stony Point,2599,2635,2018-09-18,-36,HS
9998,Success,323,0,2018-09-18,323,HS
9999,Teravista,872,841,2018-09-18,31,ES
10000,Union Hill,776,723,2018-09-18,53,ES
10001,Wells Branch,483,486,2018-09-18,-3,ES
10002,Westwood,2766,2770,2018-09-18,-4,HS
10003,LOTT,3,0,2018-09-18,3,Other
10004,Voigt,569,498,2018-09-18,71,ES
10005,Anderson Mill,582,545,2018-09-25,37,ES
10006,Blackland Prairie,830,785,2018-09-25,45,ES
10007,Bluebonnet,406,360,2018-09-25,46,ES
10008,Brushy Creek,708,729,2018-09-25,-21,ES
10009,C.D. Fulkes,767,738,2018-09-25,29,MS
10010,Cactus Ranch,967,954,2018-09-25,13,ES
10011,Caldwell Heights,794,751,2018-09-25,43,ES
10012,Canyon Creek,438,425,2018-09-25,13,ES
10013,Canyon Vista,1404,1379,2018-09-25,25,MS
10014,Cedar Ridge,2763,2769,2018-09-25,-6,HS
10015,Cedar Valley,1290,1279,2018-09-25,11,MS
10016,Chandler Oaks,566,562,2018-09-25,4,ES
10017,Chisholm Trail,943,891,2018-09-25,52,MS
10018,Berkman,482,474,2018-09-25,8,ES
10019,Deepwood,392,322,2018-09-25,70,ES
10020,Deerpark,929,924,2018-09-25,5,MS
10021,Double File Trail,641,642,2018-09-25,-1,ES
10022,DAEP,6,9,2018-09-25,-3,Other
10023,England,1217,1174,2018-09-25,43,ES
10024,Fern Bluff,609,594,2018-09-25,15,ES
10025,Forest Creek,840,809,2018-09-25,31,ES
10026,Forest North,400,360,2018-09-25,40,ES
10027,Gattis,736,735,2018-09-25,1,ES
10028,Great Oaks,758,705,2018-09-25,53,ES
10029,Hernandez,755,783,2018-09-25,-28,MS
10030,Hopewell,1208,1156,2018-09-25,52,MS
10031,JJAEP,11,6,2018-09-25,5,Other
10032,Walsh,1345,1389,2018-09-25,-44,MS
10033,Johnson,804,807,2018-09-25,-3,ES
10034,Jollyville,449,440,2018-09-25,9,ES
10035,Caraway,872,814,2018-09-25,58,ES
10036,Laurel Mountain,727,732,2018-09-25,-5,ES
10037,Herrington,1115,1116,2018-09-25,-1,ES
10038,Live Oak,603,571,2018-09-25,32,ES
10039,McNeil,2673,2758,2018-09-25,-85,HS
10040,Callison,783,810,2018-09-25,-27,ES
10041,Grisham,636,621,2018-09-25,15,MS
10042,Old Town,705,715,2018-09-25,-10,ES
10043,Sommer,1262,1289,2018-09-25,-27,ES
10044,Pearson Ranch,879,820,2018-09-25,59,MS
10045,Pond Springs,586,626,2018-09-25,-40,ES
10046,Purple Sage,493,471,2018-09-25,22,ES
10047,Early College,289,331,2018-09-25,-42,HS
10048,Ridgeview,1370,1333,2018-09-25,37,MS
10049,Robertson,446,414,2018-09-25,32,ES
10050,Round Rock,3516,3515,2018-09-25,1,HS
10051,Round Rock Opportunity Center,60,79,2018-09-25,-19,Other
10052,Spicewood,845,812,2018-09-25,33,ES
10053,Stony Point,2602,2635,2018-09-25,-33,HS
10054,Success,324,315,2018-09-25,9,HS
10055,Teravista,872,841,2018-09-25,31,ES
10056,Union Hill,774,723,2018-09-25,51,ES
10057,Wells Branch,479,486,2018-09-25,-7,ES
10058,Westwood,2771,2770,2018-09-25,1,HS
10059,LOTT,3,3,2018-09-25,0,Other
10060,Voigt,572,498,2018-09-25,74,ES
10061,Anderson Mill,587,545,2018-10-02,42,ES
10062,Blackland Prairie,830,785,2018-10-02,45,ES
10063,Bluebonnet,406,360,2018-10-02,46,ES
10064,Brushy Creek,708,729,2018-10-02,-21,ES
10065,C.D. Fulkes,769,738,2018-10-02,31,MS
10066,Cactus Ranch,964,954,2018-10-02,10,ES
10067,Caldwell Heights,794,751,2018-10-02,43,ES
10068,Canyon Creek,439,425,2018-10-02,14,ES
10069,Canyon Vista,1406,1379,2018-10-02,27,MS
10070,Cedar Ridge,2755,2769,2018-10-02,-14,HS
10071,Cedar Valley,1293,1279,2018-10-02,14,MS
10072,Chandler Oaks,567,562,2018-10-02,5,ES
10073,Chisholm Trail,943,891,2018-10-02,52,MS
10074,Berkman,480,474,2018-10-02,6,ES
10075,Deepwood,394,322,2018-10-02,72,ES
10076,Deerpark,930,924,2018-10-02,6,MS
10077,Double File Trail,641,642,2018-10-02,-1,ES
10078,DAEP,7,9,2018-10-02,-2,Other
10079,England,1216,1174,2018-10-02,42,ES
10080,Fern Bluff,610,594,2018-10-02,16,ES
10081,Forest Creek,841,809,2018-10-02,32,ES
10082,Forest North,397,360,2018-10-02,37,ES
10083,Gattis,738,735,2018-10-02,3,ES
10084,Great Oaks,756,705,2018-10-02,51,ES
10085,Hernandez,753,783,2018-10-02,-30,MS
10086,Hopewell,1213,1156,2018-10-02,57,MS
10087,JJAEP,12,6,2018-10-02,6,Other
10088,Walsh,1346,1389,2018-10-02,-43,MS
10089,Johnson,807,807,2018-10-02,0,ES
10090,Jollyville,447,440,2018-10-02,7,ES
10091,Caraway,871,814,2018-10-02,57,ES
10092,Laurel Mountain,726,732,2018-10-02,-6,ES
10093,Herrington,1114,1116,2018-10-02,-2,ES
10094,Live Oak,603,571,2018-10-02,32,ES
10095,McNeil,2669,2758,2018-10-02,-89,HS
10096,Callison,785,810,2018-10-02,-25,ES
10097,Grisham,636,621,2018-10-02,15,MS
10098,Old Town,705,715,2018-10-02,-10,ES
10099,Sommer,1263,1289,2018-10-02,-26,ES
10100,Pearson Ranch,879,820,2018-10-02,59,MS
10101,Pond Springs,586,626,2018-10-02,-40,ES
10102,Purple Sage,495,471,2018-10-02,24,ES
10103,Early College,289,331,2018-10-02,-42,HS
10104,Ridgeview,1369,1333,2018-10-02,36,MS
10105,Robertson,444,414,2018-10-02,30,ES
10106,Round Rock,3510,3515,2018-10-02,-5,HS
10107,Round Rock Opportunity Center,64,79,2018-10-02,-15,Other
10108,Spicewood,847,812,2018-10-02,35,ES
10109,Stony Point,2606,2635,2018-10-02,-29,HS
10110,Success,329,315,2018-10-02,14,HS
10111,Teravista,875,841,2018-10-02,34,ES
10112,Union Hill,773,723,2018-10-02,50,ES
10113,Wells Branch,482,486,2018-10-02,-4,ES
10114,Westwood,2772,2770,2018-10-02,2,HS
10115,LOTT,4,3,2018-10-02,1,Other
10116,Voigt,573,498,2018-10-02,75,ES
10117,Anderson Mill,587,545,2018-10-09,42,ES
10118,Blackland Prairie,830,785,2018-10-09,45,ES
10119,Bluebonnet,403,360,2018-10-09,43,ES
10120,Brushy Creek,710,729,2018-10-09,-19,ES
10121,C.D. Fulkes,768,738,2018-10-09,30,MS
10122,Cactus Ranch,966,954,2018-10-09,12,ES
10123,Caldwell Heights,797,751,2018-10-09,46,ES
10124,Canyon Creek,440,425,2018-10-09,15,ES
10125,Canyon Vista,1407,1379,2018-10-09,28,MS
10126,Cedar Ridge,2753,2769,2018-10-09,-16,HS
10127,Cedar Valley,1295,1279,2018-10-09,16,MS
10128,Chandler Oaks,568,562,2018-10-09,6,ES
10129,Chisholm Trail,944,891,2018-10-09,53,MS
10130,Berkman,481,474,2018-10-09,7,ES
10131,Deepwood,395,322,2018-10-09,73,ES
10132,Deerpark,921,924,2018-10-09,-3,MS
10133,Double File Trail,643,642,2018-10-09,1,ES
10134,DAEP,7,9,2018-10-09,-2,Other
10135,England,1222,1174,2018-10-09,48,ES
10136,Fern Bluff,607,594,2018-10-09,13,ES
10137,Forest Creek,842,809,2018-10-09,33,ES
10138,Forest North,399,360,2018-10-09,39,ES
10139,Gattis,741,735,2018-10-09,6,ES
10140,Great Oaks,757,705,2018-10-09,52,ES
10141,Hernandez,752,783,2018-10-09,-31,MS
10142,Hopewell,1217,1156,2018-10-09,61,MS
10143,JJAEP,11,6,2018-10-09,5,Other
10144,Walsh,1348,1389,2018-10-09,-41,MS
10145,Johnson,806,807,2018-10-09,-1,ES
10146,Jollyville,448,440,2018-10-09,8,ES
10147,Caraway,872,814,2018-10-09,58,ES
10148,Laurel Mountain,728,732,2018-10-09,-4,ES
10149,Herrington,1118,1116,2018-10-09,2,ES
10150,Live Oak,599,571,2018-10-09,28,ES
10151,McNeil,2673,2758,2018-10-09,-85,HS
10152,Callison,788,810,2018-10-09,-22,ES
10153,Grisham,636,621,2018-10-09,15,MS
10154,Old Town,708,715,2018-10-09,-7,ES
10155,Sommer,1263,1289,2018-10-09,-26,ES
10156,Pearson Ranch,881,820,2018-10-09,61,MS
10157,Pond Springs,588,626,2018-10-09,-38,ES
10158,Purple Sage,494,471,2018-10-09,23,ES
10159,Early College,289,331,2018-10-09,-42,HS
10160,Ridgeview,1366,1333,2018-10-09,33,MS
10161,Robertson,443,414,2018-10-09,29,ES
10162,Round Rock,3507,3515,2018-10-09,-8,HS
10163,Round Rock Opportunity Center,66,79,2018-10-09,-13,Other
10164,Spicewood,846,812,2018-10-09,34,ES
10165,Stony Point,2603,2635,2018-10-09,-32,HS
10166,Success,321,315,2018-10-09,6,HS
10167,Teravista,877,841,2018-10-09,36,ES
10168,Union Hill,772,723,2018-10-09,49,ES
10169,Wells Branch,478,486,2018-10-09,-8,ES
10170,Westwood,2772,2770,2018-10-09,2,HS
10171,LOTT,3,3,2018-10-09,0,Other
10172,Voigt,576,498,2018-10-09,78,ES
10173,Anderson Mill,593,545,2018-10-16,48,ES
10174,Blackland Prairie,832,785,2018-10-16,47,ES
10175,Bluebonnet,402,360,2018-10-16,42,ES
10176,Brushy Creek,711,729,2018-10-16,-18,ES
10177,C.D. Fulkes,771,738,2018-10-16,33,MS
10178,Cactus Ranch,964,954,2018-10-16,10,ES
10179,Caldwell Heights,798,751,2018-10-16,47,ES
10180,Canyon Creek,437,425,2018-10-16,12,ES
10181,Canyon Vista,1405,1379,2018-10-16,26,MS
10182,Cedar Ridge,2757,2769,2018-10-16,-12,HS
10183,Cedar Valley,1292,1279,2018-10-16,13,MS
10184,Chandler Oaks,568,562,2018-10-16,6,ES
10185,Chisholm Trail,944,891,2018-10-16,53,MS
10186,Berkman,481,474,2018-10-16,7,ES
10187,Deepwood,391,322,2018-10-16,69,ES
10188,Deerpark,920,924,2018-10-16,-4,MS
10189,Double File Trail,645,642,2018-10-16,3,ES
10190,DAEP,7,9,2018-10-16,-2,Other
10191,England,1225,1174,2018-10-16,51,ES
10192,Fern Bluff,607,594,2018-10-16,13,ES
10193,Forest Creek,842,809,2018-10-16,33,ES
10194,Forest North,397,360,2018-10-16,37,ES
10195,Gattis,744,735,2018-10-16,9,ES
10196,Great Oaks,758,705,2018-10-16,53,ES
10197,Hernandez,755,783,2018-10-16,-28,MS
10198,Hopewell,1218,1156,2018-10-16,62,MS
10199,JJAEP,13,6,2018-10-16,7,Other
10200,Walsh,1346,1389,2018-10-16,-43,MS
10201,Johnson,804,807,2018-10-16,-3,ES
10202,Jollyville,449,440,2018-10-16,9,ES
10203,Caraway,877,814,2018-10-16,63,ES
10204,Laurel Mountain,729,732,2018-10-16,-3,ES
10205,Herrington,1120,1116,2018-10-16,4,ES
10206,Live Oak,600,571,2018-10-16,29,ES
10207,McNeil,2674,2758,2018-10-16,-84,HS
10208,Callison,784,810,2018-10-16,-26,ES
10209,Grisham,641,621,2018-10-16,20,MS
10210,Old Town,714,715,2018-10-16,-1,ES
10211,Sommer,1263,1289,2018-10-16,-26,ES
10212,Pearson Ranch,883,820,2018-10-16,63,MS
10213,Pond Springs,594,626,2018-10-16,-32,ES
10214,Purple Sage,493,471,2018-10-16,22,ES
10215,Early College,289,331,2018-10-16,-42,HS
10216,Ridgeview,1369,1333,2018-10-16,36,MS
10217,Robertson,442,414,2018-10-16,28,ES
10218,Round Rock,3506,3515,2018-10-16,-9,HS
10219,Round Rock Opportunity Center,65,79,2018-10-16,-14,Other
10220,Spicewood,846,812,2018-10-16,34,ES
10221,Stony Point,2601,2635,2018-10-16,-34,HS
10222,Success,313,315,2018-10-16,-2,HS
10223,Teravista,877,841,2018-10-16,36,ES
10224,Union Hill,777,723,2018-10-16,54,ES
10225,Wells Branch,480,486,2018-10-16,-6,ES
10226,Westwood,2767,2770,2018-10-16,-3,HS
10227,LOTT,4,3,2018-10-16,1,Other
10228,Voigt,583,498,2018-10-16,85,ES
10229,Anderson Mill,591,545,2018-10-23,46,ES
10230,Blackland Prairie,832,785,2018-10-23,47,ES
10231,Bluebonnet,407,360,2018-10-23,47,ES
10232,Brushy Creek,713,729,2018-10-23,-16,ES
10233,C.D. Fulkes,771,738,2018-10-23,33,MS
10234,Cactus Ranch,963,954,2018-10-23,9,ES
10235,Caldwell Heights,806,751,2018-10-23,55,ES
10236,Canyon Creek,438,425,2018-10-23,13,ES
10237,Canyon Vista,1406,1379,2018-10-23,27,MS
10238,Cedar Ridge,2755,2769,2018-10-23,-14,HS
10239,Cedar Valley,1296,1279,2018-10-23,17,MS
10240,Chandler Oaks,568,562,2018-10-23,6,ES
10241,Chisholm Trail,943,891,2018-10-23,52,MS
10242,Berkman,476,474,2018-10-23,2,ES
10243,Deepwood,392,322,2018-10-23,70,ES
10244,Deerpark,925,924,2018-10-23,1,MS
10245,Double File Trail,646,642,2018-10-23,4,ES
10246,DAEP,8,9,2018-10-23,-1,Other
10247,England,1228,1174,2018-10-23,54,ES
10248,Fern Bluff,609,594,2018-10-23,15,ES
10249,Forest Creek,842,809,2018-10-23,33,ES
10250,Forest North,399,360,2018-10-23,39,ES
10251,Gattis,746,735,2018-10-23,11,ES
10252,Great Oaks,761,705,2018-10-23,56,ES
10253,Hernandez,755,783,2018-10-23,-28,MS
10254,Hopewell,1220,1156,2018-10-23,64,MS
10255,JJAEP,12,6,2018-10-23,6,Other
10256,Walsh,1347,1389,2018-10-23,-42,MS
10257,Johnson,804,807,2018-10-23,-3,ES
10258,Jollyville,453,440,2018-10-23,13,ES
10259,Caraway,876,814,2018-10-23,62,ES
10260,Laurel Mountain,731,732,2018-10-23,-1,ES
10261,Herrington,1116,1116,2018-10-23,0,ES
10262,Live Oak,598,571,2018-10-23,27,ES
10263,McNeil,2677,2758,2018-10-23,-81,HS
10264,Callison,785,810,2018-10-23,-25,ES
10265,Grisham,641,621,2018-10-23,20,MS
10266,Old Town,716,715,2018-10-23,1,ES
10267,Sommer,1257,1289,2018-10-23,-32,ES
10268,Pearson Ranch,881,820,2018-10-23,61,MS
10269,Pond Springs,593,626,2018-10-23,-33,ES
10270,Purple Sage,489,471,2018-10-23,18,ES
10271,Early College,288,331,2018-10-23,-43,HS
10272,Ridgeview,1367,1333,2018-10-23,34,MS
10273,Robertson,438,414,2018-10-23,24,ES
10274,Round Rock,3504,3515,2018-10-23,-11,HS
10275,Round Rock Opportunity Center,62,79,2018-10-23,-17,Other
10276,Spicewood,846,812,2018-10-23,34,ES
10277,Stony Point,2600,2635,2018-10-23,-35,HS
10278,Success,323,315,2018-10-23,8,HS
10279,Teravista,878,841,2018-10-23,37,ES
10280,Union Hill,774,723,2018-10-23,51,ES
10281,Wells Branch,481,486,2018-10-23,-5,ES
10282,Westwood,2760,2770,2018-10-23,-10,HS
10283,LOTT,6,3,2018-10-23,3,Other
10284,Voigt,586,498,2018-10-23,88,ES
